you -> شما
i -> من
to -> به
the -> را
and -> و
that -> که
of -> از
me -> من
in -> که در
this -> این
for -> برای
no -> نه
have -> دارند
my -> من
just -> فقط
not -> نه
do -> انجام دادن
be -> بودن
on -> بر
your -> شما
was -> بود
we -> ما
with -> با
but -> ولی
all -> همه
well -> خوب
he -> او
about -> در باره
right -> درست
get -> گرفتن
here -> اینجا
out -> بیرون
if -> اگر
her -> او
she -> او
can -> می توان
up -> بالا
want -> خواستن
now -> اکنون
go -> برو
him -> به او
there -> آنجا
one -> یکی
why -> چرا
see -> دیدن
come -> بیا
good -> خوب
they -> آنها
really -> واقعا
when -> چه زمانی
back -> بازگشت
from -> از جانب
were -> بود
yes -> آره
his -> خود
or -> یا
who -> سازمان بهداشت جهانی
because -> زیرا
some -> مقداری
then -> سپس
say -> گفتن
an -> یک
way -> مسیر
us -> ما
little -> مقدار کمی
never -> هرگز
too -> هم
sure -> مطمئن
more -> بیشتر
over -> بر فراز
our -> ما
sorry -> متاسف
where -> جایی که
let -> اجازه دهید
maybe -> شاید
down -> پایین
man -> مرد
very -> بسیار
by -> توسط
anything -> هر چیزی
much -> بسیار
any -> هر
life -> زندگی
even -> زوج
off -> خاموش
please -> لطفا
thank -> تشکر
only -> فقط
help -> کمک
two -> دو
talk -> صحبت
people -> مردم
god -> خداوند
still -> هنوز
wait -> صبر کن
into -> به
find -> پیدا کردن
again -> از نو
thing -> چیز
call -> زنگ زدن
told -> گفت
great -> عالی
before -> قبل از
better -> بهتر
ever -> همیشه
night -> شب
than -> نسبت به. تا
away -> دور
first -> اولین
believe -> ایمان داشتن
fine -> خوب
home -> خانه
after -> بعد از
last -> آخر
these -> اینها
put -> قرار دادن
around -> دور و بر
stop -> متوقف کردن
long -> طولانی
always -> همیشه
listen -> گوش کنید
those -> آن ها
big -> بزرگ
lot -> مقدار زیادی
kind -> نوع
wrong -> اشتباه
through -> از طریق
new -> جدید
guess -> حدس بزن
care -> مراقبت
bad -> بد
mom -> مادر
remember -> یاد آوردن
together -> با یکدیگر
dad -> بابا
leave -> ترک کردن
mother -> مادر
place -> محل
understand -> فهمیدن
actually -> در حقیقت
hear -> شنیدن
baby -> عزیزم
nice -> خوب
father -> پدر
else -> دیگر
stay -> ماندن
their -> آنها
course -> دوره
might -> ممکن
mind -> ذهن
every -> هر
enough -> کافی
try -> تلاش كردن
hell -> جهنم
came -> آمد
someone -> کسی
own -> خود
family -> خانواده
whole -> کل
another -> یکی دیگر
house -> خانه
yourself -> خودت
idea -> اندیشه
ask -> پرسیدن
best -> بهترین
must -> باید
old -> قدیمی
woman -> زن
hello -> سلام
which -> که
room -> اتاق
money -> پول
left -> ترک کرد
tonight -> امشب
real -> واقعی
son -> فرزند پسر
hope -> امید
name -> نام
same -> یکسان
happy -> خوشحال
pretty -> بسیار
girl -> دختر
sir -> آقا
show -> نشان می دهد
already -> قبلا، پیش از این
may -> ممکن است
next -> بعد
three -> سه
found -> یافت
world -> جهان
honey -> عسل
myself -> خودم
exactly -> دقیقا
probably -> شاید
hurt -> صدمه
both -> هر دو
while -> در حالی که
dead -> مرده
alone -> تنها
since -> از آنجا که
excuse -> بهانه
start -> شروع کنید
kill -> کشتن
hard -> سخت
today -> امروز
car -> ماشین
ready -> آماده
until -> تا زمان
without -> بدون
whatever -> هر چه
deal -> معامله
took -> گرفت
once -> یک بار
friend -> دوست
head -> سر
stuff -> چیز
most -> اکثر
worry -> نگران بودن
second -> دومین
part -> بخش
truth -> حقیقت
school -> مدرسه
face -> صورت
forget -> فراموش کردن
business -> کسب و کار
each -> هر یک
cause -> علت
soon -> به زودی
wife -> همسر
use -> استفاده کنید
chance -> شانس. فرصت
run -> اجرا کن
move -> حرکت
anyone -> هر کسی
person -> شخص
bye -> خدا حافظ
somebody -> کسی
heart -> قلب
such -> چنین
point -> نقطه
later -> بعد
meet -> ملاقات
anyway -> به هر حال
phone -> تلفن
reason -> دلیل
lost -> گمشده
look -> نگاه کن
bring -> آوردن
case -> مورد
wish -> آرزو کردن
tomorrow -> فردا
trust -> اعتماد
check -> بررسی
end -> پایان
late -> دیر
anymore -> دیگر
five -> پنج
least -> کمترین
town -> شهر
year -> سال
make -> ساختن
mean -> منظور داشتن
play -> بازی
hate -> نفرت
ago -> پیش
beautiful -> زیبا
fact -> حقیقت
crazy -> دیوانه
party -> مهمانی - جشن
sit -> بنشین
open -> باز کن
afraid -> می ترسد
between -> بین
important -> مهم
rest -> باقی مانده
fun -> سرگرم کننده
kid -> بچه
glad -> خوشحالم
everyone -> هر کس
day -> روز
sister -> خواهر
minute -> دقیقه
everybody -> همه
bit -> بیت
couple -> زن و شوهر
either -> یا
daughter -> فرزند دختر
under -> زیر
break -> زنگ تفريح
door -> در، درب
set -> تنظیم
close -> بستن
easy -> آسان
doctor -> دکتر
far -> دور
walk -> راه رفتن
need -> نیاز داشتن
trouble -> مشکل
mine -> مال خودم
though -> اگر چه
time -> زمان
different -> ناهمسان
hospital -> بیمارستان
anybody -> هر شخصی
alright -> بسیار خوب
wedding -> عروسی
shut -> بسته
able -> قادر است
die -> بمیر
perfect -> کامل
police -> پلیس
stand -> ایستادن
hit -> اصابت
story -> داستان
dinner -> شام
against -> در برابر
funny -> خنده دار
husband -> شوهر
almost -> تقریبا
stupid -> احمق
pay -> پرداخت
answer -> پاسخ
four -> چهار
office -> دفتر
cool -> سرد
news -> اخبار
child -> کودک
half -> نیم
yours -> مال شما
moment -> لحظه
sleep -> خواب
young -> جوان
men -> مردان
sonny -> پسر
lucky -> خوش شانس
pick -> انتخاب
sometimes -> گاهی
them -> آنها را
bed -> بستر
also -> همچنین
date -> تاریخ
line -> خط
lose -> از دست دادن
fire -> آتش
free -> رایگان
hand -> دست
serious -> جدی
shit -> لعنتی
behind -> پشت
inside -> داخل
high -> بالا
ahead -> در پیش
wonderful -> فوق العاده
fight -> مبارزه کردن
past -> گذشته
cut -> قطع كردن
quite -> کاملا
number -> عدد
sick -> بیمار
game -> بازی
eat -> خوردن
nobody -> هيچ كس
death -> مرگ
along -> در امتداد
finally -> سرانجام
upset -> ناراحت
seem -> به نظر می رسد
safe -> بی خطر
children -> فرزندان
front -> جلو
shot -> شلیک کرد
love -> عشق
clear -> روشن
hot -> داغ
six -> شش
drink -> نوشیدنی
absolutely -> کاملا
how -> چگونه
sweet -> شیرین
alive -> زنده
sense -> احساس، مفهوم
happen -> رخ دادن
special -> خاص
bet -> شرط
blood -> خون
lie -> دروغ
full -> پر شده
meeting -> ملاقات
dear -> عزیز
coffee -> قهوه
sound -> صدا
fault -> عیب
water -> اب
ten -> ده
women -> زنان
welcome -> خوش آمدی
buy -> خرید
hour -> ساعت
speak -> صحبت
think -> فکر
christmas -> کریسمس
body -> بدن
order -> سفارش
outside -> خارج از
hang -> آویزان شدن
worse -> بدتر
company -> شرکت
mistake -> اشتباه
handle -> رسیدگی
spend -> خرج کردن
totally -> کاملا
control -> کنترل
marriage -> ازدواج
power -> قدرت
president -> رئيس جمهور
unless -> مگر اینکه
sex -> رابطه ی جنسی
send -> ارسال
picture -> تصویر
hundred -> صد
change -> تغییر دادن
explain -> توضیح
certainly -> قطعا
sign -> امضاء کردن
boy -> پسر
relationship -> ارتباط
hair -> مو
choice -> انتخاب
anywhere -> هر جا
secret -> راز
future -> آینده
weird -> عجیب و غریب
luck -> شانس
touch -> دست زدن به
kiss -> بوسه
crane -> جرثقیل
question -> سوال
obviously -> به طور مشخص
pain -> درد
straight -> سر راست
grace -> رحمت
white -> سفید
fast -> سریع
word -> کلمه
food -> غذا
none -> هیچ یک
drive -> راندن
work -> کار کردن
marry -> ازدواج کن
light -> سبک
test -> تست
drop -> رها کردن
frank -> صریح
sent -> ارسال شد
city -> شهر
dream -> رویا
protect -> محافظت
twenty -> بیست
class -> کلاس
surprise -> تعجب
forever -> برای همیشه
poor -> فقیر
mad -> دیوانه
except -> بجز
gun -> تفنگ
know -> دانستن
dance -> رقصیدن
take -> گرفتن
especially -> بخصوص
situation -> وضعیت
besides -> بعلاوه
week -> هفته
himself -> خودش
act -> عمل کنید
worth -> ارزش
top -> بالا
expect -> انتظار
rather -> نسبتا
involve -> درگیر کردن
swear -> سوگند
piece -> قطعه
busy -> مشغول
law -> قانون
black -> سیاه
movie -> فیلم سینما
catch -> گرفتن
country -> کشور
less -> کمتر
perhaps -> شاید
step -> گام
fall -> سقوط
dog -> سگ
win -> پیروزی
personal -> شخصی
admit -> اقرار کردن
problem -> مسئله
murder -> آدم کشی
strong -> قوی
evil -> بد
feel -> احساس کنید
honest -> صادقانه
eye -> چشم
broke -> شکست
miss -> از دست دادن
tired -> خسته
evening -> عصر
human -> انسان
red -> قرمز
entire -> کل
trip -> سفر
club -> باشگاه
suppose -> فرض کنید
calm -> آرام
imagine -> تصور کنید
fair -> نمایشگاه
blame -> سرزنش کردن
street -> خیابان
apartment -> اپارتمان
court -> دادگاه
terrible -> وحشتناک
clean -> تمیز
learn -> فرا گرفتن
relax -> آروم باش
million -> میلیون
charity -> خیریه
accident -> تصادف
prove -> ثابت كردن
smart -> هوشمندانه
message -> پیام
small -> کم اهمیت
interest -> علاقه
table -> جدول
become -> تبدیل شود
mouth -> دهان
pregnant -> حامله
middle -> وسط
ring -> حلقه
careful -> مراقب باشید
shall -> باید
team -> تیم
ride -> سوار شدن
figure -> شکل
wear -> پوشیدن
shoot -> شلیک
stick -> چوب
ray -> اشعه
follow -> دنبال کردن
angry -> خشمگین
instead -> بجای
buddy -> رفیق
write -> نوشتن
early -> زود
angel -> فرشته
nick -> بریدگی کوچک
ran -> دوید
war -> جنگ
forgive -> ببخش
jail -> زندان
lunch -> ناهار
eight -> هشت
thousand -> هزار
music -> موسیقی
tough -> سخت است
tape -> نوار
count -> شمردن
college -> دانشکده
boyfriend -> دوست پسر
proud -> مغرور
agree -> موافق
birthday -> روز تولد
bill -> صورت حساب
seven -> هفت
history -> تاریخ
share -> اشتراک گذاری
offer -> پیشنهاد
hurry -> عجله کن
feet -> پا
wonder -> تعجب
simple -> ساده
decision -> تصمیم گیری
building -> ساختمان
finish -> تمام کردن
voice -> صدا
herself -> خودش
would -> خواهد شد
list -> فهرست
mess -> بهم ریختگی
deserve -> سزاوار
cute -> جذاب
dress -> لباس
interesting -> جالب هست
jesus -> عیسی
hotel -> هتل
enjoy -> لذت ببرید
quiet -> ساکت
road -> جاده
eve -> شب
short -> کوتاه
beat -> ضرب و شتم
mention -> اشاره
clothe -> لباس
neither -> هیچ کدام
fix -> ثابت
respect -> توجه
spent -> صرف کرد
prison -> زندان
attention -> توجه
near -> نزدیک
bar -> بار
pass -> عبور
gift -> هدیه
dark -> تاریک
self -> خود
normal -> طبیعی
aunt -> عمه
dollar -> دلار
lawyer -> وکیل
apart -> جدا از هم
certain -> مسلم - قطعی
plan -> طرح
girlfriend -> دوست دختر
floor -> کف
whether -> چه
everything -> همه چيز
present -> حاضر
earth -> زمین
private -> خصوصی
box -> جعبه
cover -> پوشش دادن
judge -> قضاوت کنید
sake -> منظور
mommy -> مامان
possibly -> احتمالا
worst -> بدترین
station -> ایستگاه
accept -> تایید کنید
blow -> فوت کردن، دمیدن
strange -> عجیب
save -> صرفه جویی
plane -> سطح
yesterday -> دیروز
quick -> سریع
lately -> در این اواخر
stuck -> گیر
lovely -> دوست داشتني
security -> امنیت
report -> گزارش
difference -> تفاوت
store -> فروشگاه
bag -> کیسه
ball -> توپ
single -> تنها
doubt -> شک
blue -> آبی
deep -> عمیق
park -> پارک
record -> رکورد
lord -> خداوند
join -> پیوستن
key -> کلید
captain -> کاپیتان
card -> کارت
crime -> جرم
window -> پنجره
return -> برگشت
guilty -> گناهکار
difficult -> دشوار
soul -> روح
joke -> شوخی
service -> سرویس
magic -> شعبده بازي
uncle -> عمو یا دایی
promise -> وعده
public -> عمومی
bother -> زحمت
island -> جزیره
seriously -> به طور جدی
cell -> سلول
lead -> رهبری
broken -> شکسته شده
advice -> مشاوره
somehow -> به نحوی
push -> فشار دادن
concern -> نگرانی
usually -> معمولا
boss -> رئیس
rule -> قانون
summer -> تابستان
thirty -> سی
risk -> خطر
letting -> اجازه دادن
officer -> افسر
support -> پشتیبانی
afternoon -> بعد از ظهر
born -> بدنیا آمدن
apologise -> عذر خواهی کردن
seat -> صندلی
nervous -> عصبی
across -> در سراسر
song -> ترانه
charge -> شارژ
patient -> صبور
boat -> قایق
brain -> مغز
hide -> پنهان شدن
general -> عمومی
nine -> نه
huge -> بزرگ
breakfast -> صبحانه
horrible -> ناگوار
age -> سن
awful -> خیلی بد و ناخوشایند
pleasure -> لذت
driving -> رانندگی
system -> سیستم
sell -> فروش
quit -> ترک کردن
dying -> در حال مرگ
chief -> رئیس
faith -> ایمان
gay -> همجنس گرا
month -> ماه
visit -> بازدید کنید
screw -> پیچ
letter -> حرف
decide -> تصميم گرفتن
double -> دو برابر
sad -> غمگین
press -> مطبوعات
forward -> رو به جلو
fool -> احمق
smell -> بو
spell -> هجی کردن
memory -> حافظه
mark -> علامت گذاری
slow -> آهسته. تدریجی
hungry -> گرسنه
board -> هیئت مدیره
position -> موقعیت
hearing -> شنیدن
rose -> گل سرخ
kitchen -> آشپزخانه
force -> زور
fly -> پرواز
during -> در حین
space -> فضا
kick -> لگد زدن
other -> دیگر
grab -> گرفتن
discuss -> بحث و گفتگو
third -> سوم
cat -> گربه
fifty -> پنجاه
mile -> مایل
fat -> چربی
reading -> خواندن
idiot -> ادم سفیه و احمق
rock -> سنگ
suddenly -> ناگهان
agent -> عامل
bunch -> دسته
destroy -> از بین رفتن
track -> مسیر
shoes -> کفش
scene -> صحنه
peace -> صلح
demon -> دیو
low -> کم
consider -> در نظر گرفتن
drunk -> مست
tell -> بگو
knock -> در زدن
bell -> زنگ
cash -> پول نقد
give -> دادن
department -> بخش
nose -> بینی
turn -> دور زدن
keep -> نگاه داشتن
beer -> آبجو
sooner -> زودتر
plenty -> فراوانی
extra -> اضافی
attack -> حمله کنند
ground -> زمین
whose -> که
weekend -> تعطیلات آخر هفته
matter -> موضوع
wrote -> نوشت
type -> نوع
opportunity -> فرصت
king -> پادشاه
impossible -> غیر ممکن
book -> کتاب
machine -> دستگاه
waste -> هدر
pretend -> تظاهر کن
danger -> خطر
wall -> دیوار
jump -> پرش
proof -> اثبات
complete -> کامل
arrest -> دستگیری
perfectly -> کاملا
warm -> گرم
pull -> کشیدن
twice -> دو برابر
easier -> آسان تر
suit -> کت و شلوار
romantic -> رومانتیک
drug -> دارو
comfortable -> راحت
fit -> مناسب
divorce -> طلاق
begin -> شروع
closely -> به طرز نزدیک
ruin -> خراب کردن
although -> با اينكه
smile -> لبخند
laugh -> خنده
fish -> ماهی
treat -> درمان شود
fear -> ترس
amber -> کهربا
guy -> پسر
otherwise -> در غیر این صورت
excited -> برانگیخته
mail -> پست الکترونیکی
green -> سبز
stole -> دزدید
notice -> اطلاع
excellent -> عالی
pop -> ترکیدن
paper -> کاغذ
bottom -> پایین
note -> توجه داشته باشید
sudden -> ناگهانی
church -> کلیسا
bathroom -> حمام
sing -> آواز خواندن
glass -> شیشه
tree -> درخت
contact -> مخاطب
shop -> فروشگاه
reach -> رسیدن
cry -> گریه کردن
cake -> کیک
partner -> شریک
bus -> اتوبوس
computer -> کامپیوتر
study -> مطالعه
star -> ستاره
area -> حوزه
wind -> باد
chicken -> مرغ
dry -> خشک
hero -> قهرمان
error -> خطا
are -> هستند
build -> ساختن
sea -> دریا
saturday -> شنبه
add -> اضافه کردن
birth -> تولد
bird -> پرنده
grandmother -> مادر بزرگ
heavy -> سنگین
west -> غرب
lesson -> درس
heat -> حرارت
speed -> سرعت
milk -> شیر
rain -> باران
sugar -> قند
market -> بازار
process -> روند
stone -> سنگ
serve -> خدمت
river -> رودخانه
super -> فوق العاده
monkey -> میمون
pig -> خوک
chat -> چت کردن
signal -> علامت
cup -> فنجان
bee -> زنبور عسل
a -> آ
above -> در بالا
addition -> علاوه بر این
among -> در میان
amount -> میزان
angle -> زاویه
animal -> حیوان
appear -> به نظر می رسد
apple -> سیب
art -> هنر
as -> مانند
at -> در
bank -> بانک
base -> پایه
bear -> خرس
belong -> تعلق داشتن
block -> مسدود کردن
bone -> استخوان
brown -> رنگ قهوه ای
cannot -> نمی تواند
capital -> سرمایه، پایتخت
carry -> حمل
centre -> مرکز
century -> قرن
circle -> دایره
cloud -> ابر
cost -> هزینه
cold -> سرد
column -> ستون
common -> مشترک
compere -> مقایسه کردن
condition -> وضعیت
contain -> حاوی
continue -> ادامه هید
cook -> پختن
copy -> کپی 🀄
cow -> گاو
create -> ایجاد کردن
cross -> صلیب
crowd -> جمعیت
describe -> توصیف کردن
desert -> کویر
design -> طرح
detail -> جزئیات
dictionary -> فرهنگ لغت
direction -> جهت
ear -> گوش
east -> شرق
like -> پسندیدن
edge -> حاشیه، غیرمتمرکز
effect -> اثر
egg -> تخم مرغ
element -> عنصر
energy -> انرژی
engine -> موتور
england -> انگلستان
english -> انگلیسی
example -> مثال
express -> بیان
famous -> معروف
farm -> مزرعه
field -> رشته
finger -> انگشت
flat -> تخت
flower -> گل
foot -> پا
forest -> جنگل
form -> فرم
fresh -> تازه
fruit -> میوه
garden -> باغ
gas -> گاز
gold -> طلا
group -> گروه
grow -> رشد
hat -> کلاه
hole -> سوراخ
horse -> اسب
hunt -> شکار کردن
ice -> یخ
inch -> اینچ
include -> عبارتند از
increase -> افزایش دادن
indicate -> نشان می دهد
information -> اطلاعات
insect -> حشره
instrument -> ابزار
iron -> اهن
is -> است
itself -> خود
job -> کار
lady -> خانم
lake -> دریاچه
land -> زمین
language -> زبان
large -> بزرگ
lay -> غیر روحانی
leg -> پا
length -> طول
level -> مرحله
lift -> بلند کردن
main -> اصلی
many -> زیاد
map -> نقشه
march -> مارس
bacon -> بیکن
gap -> شکاف
pan -> ماهی تابه
read -> خواندن
made -> ساخته شده است
morning -> صبح
okay -> باشه
autumn -> فصل پاييز
aggravation -> تشدید
archaic -> قدیمی، کهنه
pertinent -> مرتبط
rid -> خلاص شدن از شر
defense -> دفاع
planning -> برنامه ریزی
flight -> پرواز
honestly -> صادقانه
remind -> به یاد آوردن
witness -> شاهد
dare -> جرات
hardly -> به ندرت
steal -> کش رفتن
princess -> شاهزاده
silly -> احمقانه
teach -> آموزش دهید
plus -> به علاوه
trial -> آزمایش
roll -> رول
radio -> رادیو
dirty -> کثیف
choose -> انتخاب کنید
emergency -> اضطراری
credit -> اعتبار
obvious -> واضح
loving -> با محبت
positive -> مثبت
nut -> مهره
price -> قیمت
goodbye -> خداحافظ
guard -> نگهبان
mood -> حالت
total -> جمع
crap -> چرندیات
crying -> گریان
trick -> فوت و فن
pressure -> فشار
arm -> بازو
dressed -> لباس پوشیده
taste -> طعم
neck -> گردن
south -> جنوب
something -> چیزی
nurse -> پرستار
raise -> بالا بردن
lots -> مقدار زیادی
mister -> آقا
whoever -> هر کسی که
breaking -> شکستن
file -> فایل
lock -> قفل کردن
wine -> شراب
writing -> نوشتن
spot -> نقطه
assume -> فرض
asleep -> خواب
legal -> مجاز
justice -> عدالت
bedroom -> اتاق خواب
shower -> دوش
camera -> دوربین
fill -> پر کردن
forty -> چهل
bigger -> بزرگتر
nope -> جواب منفی
breath -> نفس
pants -> شلوار
freak -> چیز غریب
french -> فرانسوی
action -> عمل
folks -> مردم
cream -> کرم رنگ
focus -> تمرکز
wild -> وحشی
truly -> براستی
desk -> میز کار
convince -> متقاعد کردن
client -> مشتری
threw -> انداخت
band -> باند
allow -> اجازه
grand -> بزرگ
shirt -> پیراهن
chair -> صندلی
rough -> خشن
government -> دولت
harry -> هری
going -> رفتن
empty -> خالی
round -> گرد
insane -> مجنون
hall -> سالن
aware -> آگاه
pack -> بسته
meaning -> معنی
tight -> تنگ
ship -> کشتی
subject -> موضوع
guest -> مهمان
match -> همخوانی داشتن
sun -> آفتاب
confused -> سردرگم
surgery -> عمل جراحي
bottle -> بطری
beyond -> فراتر
opinion -> نظر
naked -> برهنه
held -> برگزار شد
necessary -> لازم است
barely -> به سختی
health -> سلامتی
video -> ویدئو
cousin -> عمو زاده
twelve -> دوازده
simply -> به سادگی
skin -> پوست
often -> غالبا
fifteen -> پانزده
spirit -> روح
speech -> سخن، گفتار
issue -> موضوع
final -> نهایی
result -> نتیجه
code -> کد
research -> پژوهش
nowhere -> هیچ جایی
escape -> در رفتن
biggest -> بزرگترین
restaurant -> رستوران
page -> صفحه
grateful -> سپاسگزار
usual -> معمولی
burn -> سوختن
address -> نشانی
within -> در داخل
someplace -> جایی
everywhere -> هر کجا
train -> قطار - تعلیم دادن
film -> فیلم
regret -> پشیمان شدن. پشیمانی
goodness -> خوبی
heaven -> بهشت
responsibility -> مسئولیت
suspect -> مشکوک
corner -> گوشه
terrific -> فوق العاده
mission -> ماموریت
further -> به علاوه
truck -> کامیون
following -> ذیل
teeth -> دندان ها
ruined -> خراب
split -> شکاف
airport -> فرودگاه
bite -> گاز گرفتن
older -> مسن تر
liar -> دروغ گو
van -> ون
project -> پروژه
desperate -> مستاصل
themselves -> خودشان
search -> جستجو کردن
damage -> خسارت
spoke -> صحبت کرد
quickly -> به سرعت
scare -> ترساندن
beach -> ساحل دریا
afford -> استطاعت داشتن
vote -> رای
settle -> حل کن
passion -> شور
friday -> جمعه
tie -> کراوات
upon -> بر
rush -> هجوم بردن
natural -> طبیعی
champagne -> شامپاین
connection -> ارتباط
happiness -> شادی
saving -> صرفه جویی در
personally -> شخصا
suggest -> پیشنهاد می دهد
ticket -> بلیط
taught -> تدریس
loose -> شل
holy -> مقدس
staff -> کارکنان
planet -> سیاره
duty -> وظیفه
loud -> با صدای بلند
practice -> تمرین
bright -> روشن
army -> ارتش
warning -> هشدار
miracle -> معجزه
carrying -> حمل کردن
flying -> پرواز کردن
blind -> کور
queen -> ملکه
ugly -> زشت
shopping -> خريد كردن
monster -> هیولا
sight -> منظره
vampire -> خون آشام
bride -> عروس
coat -> کت
account -> حساب
clearly -> به وضوح
celebrate -> جشن گرفتن
brilliant -> درخشان
moon -> ماه
lips -> لب
custody -> حضانت
center -> مرکز
size -> اندازه
toast -> نان تست
student -> دانشجو
however -> با این حال
professional -> حرفه ای
reality -> واقعیت
attitude -> نگرش
advantage -> مزیت - فایده - سود - منفعت
grandfather -> بابا بزرگ
sold -> فروخته شد
grandma -> مادر بزرگ
beg -> گدایی کردن
someday -> روزی
grade -> مقطع تحصیلی
cheese -> پنیر
roof -> سقف
pizza -> پیتزا
powerful -> قدرتمند
fake -> جعلی
opening -> افتتاح
sally -> سالی
eventually -> در نهایت
exciting -> هیجان انگیز
covered -> سرپوشیده
familiar -> آشنا
bomb -> بمب
bout -> مبارزه
television -> تلویزیون
harmony -> هماهنگی
colour -> رنگ
schedule -> برنامه
capable -> توانا
master -> استاد
practically -> عملا
correct -> درست
clue -> سرنخ
forgotten -> فراموش شده
appointment -> وقت ملاقات
social -> اجتماعی
nature -> طبیعت
teacher -> معلم
threat -> تهدید
bloody -> خونین
lonely -> تنها
shame -> شرم
local -> محلی
jacket -> ژاکت
hook -> قلاب
scary -> ترسناک
loser -> بازنده
invite -> دعوت
merry -> شاد
port -> بندر
precious -> گرانبها
criminal -> جنایی
growing -> در حال رشد
victim -> قربانی
professor -> استاد
funeral -> مراسم خاکسپاری
couch -> نیمکت
strength -> استحکام - قدرت
loss -> ضرر - زیان
view -> چشم انداز
beauty -> زیبایی
several -> چندین
shock -> شوکه شدن
chocolate -> شکلات
greatest -> بزرگترین
miserable -> بدبخت
character -> شخصیت
became -> تبدیل شد
enemy -> دشمن
crash -> تصادف در
recognize -> تشخیص
healthy -> سالم
boring -> حوصله سر بر
feed -> خوراک
engage -> مشغول کردن
percent -> درصد
purpose -> هدف
north -> شمال
knife -> چاقو
drag -> بکشید
fan -> پنکه
badly -> بد
hire -> استخدام
curious -> کنجکاو
paint -> رنگ کردن
pardon -> عفو
built -> ساخته شده
closet -> کمد لباس
candy -> آب نبات
warn -> هشدار دهد
post -> پست
survive -> زنده ماندن
operation -> عمل
dump -> زباله
rent -> اجاره
trade -> تجارت
thanksgiving -> شکرگزاری
revenge -> انتقام گرفتن
available -> در دسترس
program -> برنامه
prefer -> ترجیح می دهند
spare -> یدکی
pray -> نماز خواندن
aside -> گذشته از
statement -> بیانیه
sometime -> چند وقت
meat -> گوشت
fantastic -> خارق العاده
launch -> راه اندازی
tip -> نکته
affair -> امر
depend -> بستگی دارد
jury -> هیئت داوران
national -> ملی
brave -> شجاع
storm -> طوفان
prince -> شاهزاده
interview -> مصاحبه
football -> فوتبال
sexy -> سکسی
explanation -> توضیح
style -> سبک
assistant -> دستیار
stronger -> قوی تر
pie -> پای
handsome -> خوش قیافه
unbelievable -> باور نکردنی
anytime -> هر زمان
nearly -> تقریبا
shake -> تکان دادن
wherever -> هر کجا که
medicine -> پزشکی
lousy -> کثیف
circumstance -> چگونگی، امر، تفصیل، شرایط محیط، پیش امد، شرح
stage -> صحنه
weak -> ضعیف
license -> مجوز
nothing -> هیچ چی
community -> انجمن
trash -> زباله ها
slip -> لیز خوردن
awake -> بیدار
friendship -> دوستی
stomach -> معده
weapon -> سلاح
mystery -> رمز و راز
official -> رسمی
regular -> منظم
valley -> دره
contract -> قرارداد
sexual -> جنسی
race -> نژاد
basically -> اساسا
switch -> تعویض
frankly -> رک و پوست کنده
cheap -> ارزان
lifetime -> طول عمر
deny -> انکار
painting -> رنگ آمیزی
clock -> ساعت
weight -> وزن
tear -> اشک
dig -> حفر کردن
bullet -> گلوله
indeed -> در واقع
changing -> تغییر می کند
tiny -> کوچک
particular -> خاص
draw -> قرعه کشی
decent -> نجیب
spring -> بهار
avoid -> اجتناب کردن
united -> متحد
score -> نمره
disappear -> ناپدید می شوند
stranger -> غریبه
exact -> دقیق
harm -> صدمه
recently -> به تازگی
snow -> برف
fortune -> ثروت
strike -> ضربه
insurance -> بیمه
fancy -> تفننی
drove -> راند
career -> حرفه
shape -> شکل
stock -> موجودی
fashion -> روش
freedom -> آزادی
timing -> زمان سنجی
guarantee -> ضمانت
chest -> قفسه سینه
bridge -> پل
woke -> بیدار شد
source -> منبع
theory -> تئوری
camp -> اردوگاه
original -> اصلی
juice -> آب میوه
access -> دسترسی داشته باشید
watch -> تماشا کردن
heading -> عنوان
selfish -> خود خواه
oil -> روغن
wise -> عاقل
period -> عادت زنانه
doll -> عروسک
committed -> متعهد شد
freeze -> یخ زدگی
noise -> سر و صدا
exist -> وجود داشته باشد
science -> علوم پایه
pair -> جفت
sat -> نشست
player -> بازیکن
ceremony -> مراسم
uncomfortable -> ناراحت
peg -> گیره
bike -> دوچرخه
weather -> آب و هوا
mostly -> اغلب
stress -> فشار
permission -> اجازه
possibility -> امکان پذیری
faster -> سریعتر
borrow -> امانت گرفتن
release -> رهایی
ate -> خورد
joy -> شادی
junior -> جوان
property -> ویژگی
negative -> منفی
fabulous -> شگفت آور
vision -> چشم انداز
member -> عضو
battle -> نبرد
term -> مدت، اصطلاح
devil -> شیطان
what -> چی
meal -> وعده غذایی
fellow -> همکار
apology -> معذرت خواهی
anger -> عصبانیت
honeymoon -> ماه عسل
wet -> مرطوب
bail -> وثیقه
parking -> توقفگاه خودرو
hung -> آویزان شد
protection -> حفاظت
manager -> مدیر
dawn -> سپیده دم
chinese -> چینی ها
campaign -> پویش
wash -> شستشو
sensitive -> حساس
photo -> عکس
chose -> انتخاب کرد
comfort -> راحتی
worrying -> نگران کننده
whom -> چه کسی
pocket -> جیب
bleeding -> خون ریزی
shoulder -> شانه
ignore -> چشم پوشی
fourth -> چهارم
talent -> استعداد
garage -> گاراژ
travel -> مسافرت رفتن
success -> موفقیت
training -> آموزش
rude -> بی ادب
crack -> ترک
model -> مدل
radar -> رادار
grew -> رشد کرد
remain -> ماندن
soft -> نرم
meantime -> در ضمن
connected -> متصل
chase -> تعقیب
cast -> قالب
cancer -> سرطان
sky -> آسمان
likely -> احتمال دارد
fate -> سرنوشت
bury -> دفن کردن
hug -> در آغوش گرفتن
brother -> برادر
driver -> راننده
concentrate -> تمرکز
throat -> گلو
prom -> پارتی
unit -> واحد
intend -> قصد داشتن - خواستن
crew -> خدمه
ashame -> شرمنده
midnight -> نیمه شب
manage -> مدیریت کنید
guilt -> گناه
terms -> مقررات
interrupt -> قطع کردن
guts -> دل و روده
tongue -> زبان
distance -> فاصله
conference -> کنفرانس
treatment -> رفتار
shoe -> کفش
basement -> زیر زمین
sentence -> جمله
purse -> کیف پول
glasses -> عینک
cabin -> کابین
universe -> کائنات
towards -> به سمت
repeat -> تکرار
mirror -> آینه
wound -> زخم
tall -> بلند قد
reaction -> واکنش
odd -> فرد
engagement -> نامزدی
therapy -> درمان
emotional -> عاطفی
magazine -> مجله
soup -> سوپ
society -> جامعه
sue -> شکایت کند
stake -> سهام
chef -> سرآشپز
awesome -> عالی
genius -> نابغه
extremely -> فوق العاده
entirely -> به طور کامل
nasty -> زننده
expensive -> گران
counting -> با احتساب
kidnapping -> آدم ربایی
square -> مربع
cleaning -> تمیز کردن
shift -> تغییر مکان
plate -> بشقاب
trapped -> به دام افتاده
male -> نر
tour -> تور
charming -> جذاب
attractive -> جذاب
argue -> جر و بحث
sunday -> یکشنبه
whip -> شلاق زدن
settled -> مستقر شده
package -> بسته بندی
laid -> گذاشته
disease -> مرض
bust -> نیم تنه
staircase -> راه پله
alarm -> زنگ خطر. هشدار
pure -> خالص
nail -> ناخن - میخ
nerve -> عصب
incredibly -> بطور باور نکردنی
hill -> تپه
lane -> مسیر
dirt -> خاک
bond -> رابطه، رشته
stamp -> مهر
becoming -> تبدیل شدن
terribly -> به طرز وحشتناکی
friendly -> دوستانه
easily -> به آسانی
damn -> لعنتی
suffering -> رنج کشیدن
disgusting -> چندش آور
deliver -> ارائه
riding -> سواری
federal -> فدرال
disaster -> فاجعه
rate -> نرخ
trap -> تله
claim -> مطالبه
turkey -> بوقلمون
spoken -> صحبت کرد
snake -> مار
introduce -> معرفی کنید
rescue -> نجات
confession -> اعتراف
lover -> عاشق
impression -> احساس؛ عقیده؛ گمان
gate -> دروازه
fantasy -> فانتزی
reputation -> شهرت، آبرو
it -> آی تی
knowledge -> دانش
inn -> مسافرخانه
europe -> اروپا
suffer -> رنج بردن
argument -> بحث و جدل
homework -> مشق شب
cancel -> لغو
director -> کارگردان
bath -> حمام
prepare -> آماده کردن
wheel -> چرخ
crisis -> بحران
monday -> دوشنبه
pink -> رنگ صورتی
gentleman -> جنتلمن
toilet -> توالت
agreement -> توافق
ill -> بیمار
eleven -> یازده
wide -> وسیع
popular -> محبوب
clinic -> درمانگاه
exchange -> تبادل
university -> دانشگاه
load -> بار
winter -> زمستان
swim -> شنا کردن
holiday -> تعطیلات
material -> مواد
parent -> والدین
wood -> چوب
article -> مقاله
math -> ریاضی
grant -> اعطا کردن
orange -> نارنجی
thursday -> پنج شنبه
dozen -> دوجین
bread -> نان
silence -> سکوت
duck -> اردک
seventy -> هفتاد
butter -> کره
carrot -> هویج
alcohol -> الکل
mum -> مامان
headache -> سردرد
tennis -> تنیس
tuesday -> سهشنبه
theatre -> تئاتر
ninety -> نود
guide -> راهنما
royal -> سلطنتی
ability -> توانایی
wing -> بال
tradition -> سنت
towel -> حوله
earn -> بدست آوردن
habit -> عادت داشتن
event -> رویداد
basket -> سبد
balance -> تعادل
exercise -> ورزش
forth -> به پیش
eighteen -> هجده
perform -> انجام دادن
everyday -> هر روز
village -> دهکده
journey -> سفر
supply -> عرضه
helpful -> مفید
useless -> بلا استفاده
fourteen -> چهارده
gum -> آدامس
replace -> جایگزین کردن
emotion -> هیجانی
stubborn -> یک دنده
provide -> فراهم کند
beef -> گوشت گاو
nephew -> پسر خواهر یا برادر
victory -> پیروزی
title -> عنوان
furniture -> مبلمان
blanket -> پتو
surface -> سطح
niece -> دختر برادر یا خواهر و غیره
gloves -> دستکش
soap -> صابون
signature -> امضا
zoo -> باغ وحش
cope -> کنار آمدن
compound -> ترکیب
abuse -> سو استفاده کردن
accurate -> دقیق
acquire -> بدست آوردن
bake -> پختن
barrier -> مانع
battery -> باتری
beard -> ریش
behave -> رفتار كردن
beside -> در كنار
bicycle -> دوچرخه
bin -> صندوقچه
biscuit -> بیسکویت
bonus -> جایزه
brush -> قلم مو
bucket -> سطل
budget -> بودجه
butcher -> قصاب
carpet -> فرش
centimetre -> سانتی متر
cereal -> غلات
certificate -> گواهی
champion -> قهرمان
chemical -> شیمیایی
cheque -> بررسی
cherry -> گیلاس
cigarette -> سیگار
cinema -> سینما
citizen -> شهروند
classroom -> کلاس درس
data -> داده ها
darling -> عزیز
deaf -> کر
delay -> تاخیر انداختن
diary -> دفتر خاطرات
dish -> ظرف
eastern -> شرقی
economic -> اقتصادی
email -> پست الکترونیک
employ -> استخدام کردن
enable -> فعال کردن
fee -> هزینه
finance -> دارایی، مالیه، سرمایه گذاری
flow -> جریان
formula -> فرمول
frequent -> زود زود
fridge -> یخچال
fry -> سرخ کردن
fulfil -> برآورده کند
industry -> صنعت
injury -> صدمه
institute -> موسسه
jam -> مربا
journalist -> روزنامه نگار
absence -> غیبت
keen -> تیز
kettle -> کتری
keyboard -> صفحه کلید
knee -> زانو
label -> برچسب
laboratory -> آزمایشگاه
labour -> کار یدی
lack -> عدم
ladder -> نردبان
lamb -> گوشت بره
lamp -> لامپ
landlord -> صاحب خانه
lazy -> تنبل
leader -> رهبر
leadership -> رهبری
leaf -> برگ
lean -> لاغر
leather -> چرم
lend -> قرض دادن
leisure -> اوقات فراغت
log -> ورود به سیستم
logical -> منطقی
lorry -> کامیون
library -> کتابخانه
mainly -> به طور عمده
maintain -> حفظ
maintenance -> نگهداری
major -> عمده
mall -> مرکز خرید
manner -> شیوه
margin -> لبه
marvellous -> شگفت انگیز
massive -> عظیم
narrow -> محدود، تنگ
native -> بومی
naughty -> شیطون
nearby -> در نزدیکی
neighbour -> همسایه
net -> خالص
network -> شبکه
nicely -> به خوبی
no way -> به هیچ وجه
object -> هدف - شی
objection -> اعتراض
obligation -> تعهد
observation -> مشاهده
observe -> رعایت کنید
obtain -> به دست آوردن
occasion -> مناسبت
occupy -> را اشغال کند
occur -> روی دادن
ocean -> اقیانوس
o'clock -> ساعت
of course -> البته
operate -> عمل کنند
oppose -> مخالفت کنند
pace -> سرعت
pad -> پد
palace -> قصر
pale -> رنگ پریده
panic -> وحشت
parcel -> بسته
parliament -> مجلس
participate -> شرکت کردن
partly -> تا حدی
passenger -> مسافر
patience -> صبر
path -> مسیر
pattern -> الگو
pause -> مکث
payment -> پرداخت
qualify -> واجد شرایط شدن
quality -> کیفیت
quantity -> تعداد
rail -> ریل
railway -> راه آهن
range -> دامنه
rapid -> سریع
rare -> نادر
rarely -> به ندرت
react -> واکنش نشان دهند
receipt -> اعلام وصول
receive -> دريافت كردن
safety -> ایمنی
sail -> سفر دریایی
salad -> سالاد
salary -> حقوق
sale -> فروش
salt -> نمک
sand -> شن
sandwich -> ساندویچ
satellite -> ماهواره
satisfaction -> رضایت
sauce -> سس
sausage -> سوسیس
scale -> مقیاس
scheme -> طرح
scratch -> خراش
screen -> صفحه نمایش
script -> اسکریپت
seal -> مهر
season -> فصل
secondary -> ثانوی
seed -> دانه
seek -> به دنبال
select -> انتخاب کنید
senior -> ارشد
sensible -> معقول
separate -> جداگانه، مجزا
sequence -> توالی
servant -> خدمتگزار
session -> جلسه
settlement -> توافق
severe -> شدید
shadow -> سایه
tablet -> تبلت
tail -> دم
tale -> داستان
tap -> ضربه زدن
target -> هدف
task -> وظیفه
tax -> مالیات
taxi -> تاکسی
tea -> چای
telly -> تلویزیونی
technology -> فن آوری
telephone -> تلفن
temperature -> درجه حرارت
unable -> قادر نیست
undertake -> بعهده گرفتن
uniform -> لباس فرم
unlike -> بر خلاف
vacation -> تعطیلات
variation -> تغییر
vary -> متفاوت
vast -> وسیع
vegetable -> سبزی
yard -> حیاط
yellow -> رنگ زرد
wage -> حق الزحمه
wake -> از خواب بیدار
wander -> پرسه زدن
ward -> بخش
wardrobe -> جا رختی
weakness -> ضعف
wealth -> ثروت
web -> وب
website -> سایت اینترنتی
western -> غربی
whatsoever -> به هر حال
whereas -> در حالیکه
wooden -> چوبی
wool -> پشم
workshop -> کارگاه
kilometre -> کیلومتر
largely -> تا حد زیادی
lunchtime -> وقت ناهار
link -> ارتباط دادن
liquid -> مایع
limit -> حد
literature -> ادبیات
mushroom -> قارچ
musical -> موزیکال
muscle -> ماهیچه
movement -> جنبش
mouse -> موش
mountain -> کوه
northern -> شمالی
overseas -> خارج از کشور
ownership -> مالکیت
programme -> برنامه
pupil -> شاگرد
pub -> میخانه
primarily -> در درجه اول
presume -> فرض
predict -> پیش بینی
practise -> تمرین
praise -> ستایش
potato -> سیب زمینی
post office -> اداره پست
pool -> استخر
politician -> سیاستمدار
policeman -> پلیس
poem -> شعر
plug -> پلاگین
petrol -> بنزین
pepper -> فلفل
pension -> حقوق بازنشستگی
pencil -> مداد
reduce -> کاستن
region -> منطقه
rice -> برنج
scientist -> دانشمند
sheep -> گوسفند
sheet -> ورق
shelf -> تاقچه
shout -> فریاد
singer -> خواننده
slice -> تکه
slim -> باریک
smoking -> سیگار کشیدن
sole -> تنها
spoon -> قاشق
steak -> استیک
strawberry -> توت فرنگی
strict -> سخت گیرانه
struggle -> تقلا
submit -> ارسال
supermarket -> سوپر مارکت
supper -> عصرانه
symbol -> نماد
territory -> قلمرو
text -> متن
toe -> انگشت پا
tomato -> گوجه فرنگی
tooth -> دندان
tourist -> توریست
tower -> برج
traditional -> سنتی
translate -> ترجمه کردن
transport -> حمل و نقل
trousers -> شلوار
tube -> لوله
unlikely -> بعید
useful -> مفید
via -> از طریق
visual -> دیداری
volume -> جلد
yet -> هنوز
youth -> جوانان
had -> داشته است
investigation -> تحقیق و بررسی
vine -> تاک
t-shirt -> تی شرت
apricot -> زردآلو
attribute -> صفت
beetle -> سوسک
bracket -> براکت
concise -> مختصر
decay -> پوسیدگی
doze -> چرت زدن
farther -> دورتر
lavatory -> دستشویی
litre -> لیتر
metre -> متر
noun -> اسم
pigeon -> کبوتر
porridge -> فرنی
raspberry -> تمشک
appreciate -> قدردانی
responsible -> مسئول
fought -> جنگید
pride -> غرور
solve -> حل
hopefully -> خوشبختانه
pine -> کاج
mate -> رفیق
illegal -> غیر مجاز
matt -> مات
con -> باهم
maid -> خدمتکار
punch -> مشت زدن
mayor -> شهردار
recall -> به خاطر آوردن
bug -> حشره
defend -> دفاع
painful -> دردناک
rat -> موش صحرایی
cooking -> پخت و پز
button -> دکمه
sixty -> شصت
pity -> حیف
coach -> مربی
row -> ردیف
awhile -> مدتی
pen -> خودکار
confidence -> اعتماد به نفس
carter -> کارتر
image -> تصویر
hers -> مال او
role -> نقش
refuse -> رد کردن
determined -> مشخص
progress -> پیش رفتن
military -> نظامی
artist -> هنرمند
gym -> سالن ورزش
cruel -> ظالمانه
traffic -> ترافیک
mental -> ذهنی
poison -> سم
expert -> کارشناس
bull -> گاو نر
benefit -> سود
secretary -> دبیر، منشی
sneak -> یواشکی
mix -> مخلوط کردن
firm -> محکم
privacy -> حریم خصوصی
pot -> گلدان
twins -> دوقلوها
swing -> تاب خوردن
successful -> موفقیت آمیز
scream -> فریاد زدن
solid -> جامد
flash -> فلاش
crush -> خرد کردن
ambulance -> آمبولانس
wallet -> کیف پول
discovery -> کشف
officially -> رسما
gang -> دسته
till -> تا
rise -> بالا آمدن
option -> گزینه
laundry -> خشکشویی
former -> سابق
assure -> اطمینان دادن
skip -> جست و خیز کردن
fail -> مردود شدن
accuse -> متهم کردن
plant -> گیاه
lower -> پایین تر
bored -> خسته
soda -> جوش شیرین
silver -> نقره
sheriff -> کلانتر
suite -> سوئیت
section -> بخش
commit -> مرتکب شدن
suicide -> خودکشی کردن
spread -> انتشار دادن
fishing -> صید ماهی
bat -> خفاش
yell -> فریاد زدن
league -> لیگ
proper -> مناسب
fifth -> پنجم
solution -> راه حل
sharp -> تیز
giant -> غول
nor -> نه
latest -> آخرین
ash -> خاکستر
highly -> بسیار
audience -> حضار
winner -> برنده
insist -> اصرار کنید
cheer -> تشویق کردن
flesh -> گوشت
district -> ناحیه
routine -> روال
adult -> بالغ
spike -> سنبله
awfully -> به طرز وحشتناکی
thin -> لاغر
fever -> تب
female -> زن
sweat -> عرق
silent -> بی صدا
clever -> باهوش
request -> درخواست
prize -> جایزه
fully -> به طور کامل
estate -> املاک
union -> اتحاد. اتصال
goodnight -> شب بخیر
divorced -> جدا شده
despite -> با وجود
surely -> مسلما
confess -> اعتراف کردن
bless -> برکت دادن
chip -> تراشه
zero -> صفر
potential -> پتانسیل
wolf -> گرگ
chill -> سرد شدن
blonde -> طلایی
brains -> مغزها
agency -> آژانس
degree -> درجه
unusual -> غیر معمول
joint -> مفصل
rob -> غارت
cure -> درمان
covering -> پوشش
newspaper -> روزنامه
coast -> ساحل
grave -> قبر
direct -> مستقیم
cheating -> تقلب کردن
quarter -> ربع
mixed -> مختلط
brand -> نام تجاری
toy -> اسباب بازی
policy -> خط مشی
competition -> رقابت
reasonable -> معقول
curse -> لعنت
dessert -> دسر
rolling -> متحرک
alien -> بیگانه
cloth -> پارچه
ancient -> کهن
wore -> پوشید
value -> ارزش
site -> سایت
secure -> امن است
spit -> تف انداختن
pilot -> خلبان
penny -> پنی
offense -> توهین
dust -> گرد و خاک
conscience -> وجدان
invitation -> دعوت
hidden -> پنهان شده است
grief -> غم و اندوه
smiling -> خندان
destiny -> سرنوشت
bowl -> کاسه
pregnancy -> بارداری
prisoner -> زندانی
delivery -> تحویل
virus -> ویروس
shrink -> کوچک شدن
influence -> نفوذ
freezing -> انجماد
concert -> کنسرت
wreck -> خراب کردن
chain -> زنجیر
walker -> واکر
wire -> سیم
presence -> حضور
anxious -> مشتاق
version -> نسخه
wishes -> آرزوها
bound -> مقید شده است
charm -> افسون
frame -> قاب
boom -> رونق
vice -> معاون
opera -> اپرا
nonsense -> مزخرف
fright -> ترس
downtown -> مرکز شهر
actual -> واقعی
spin -> چرخش
classic -> کلاسیک
civil -> مدنی
tool -> ابزار
education -> تحصیلات
wrap -> بسته بندی کردن
torture -> شکنجه
location -> محل
loan -> وام
effort -> تلاش
owner -> مالک
fairy -> پری
per -> مطابق
necessarily -> لزوما
county -> شهرستان
contest -> مسابقه
print -> چاپ
motel -> متل
directly -> به طور مستقیم
underwear -> زیر شلواری
exhaust -> اگزوز
particularly -> به ویژه
carefully -> با دقت
trace -> پی گیری
smooth -> صاف
recovery -> بهبود
intention -> قصد
enter -> وارد
belt -> کمربند
standard -> استاندارد
sacrifice -> قربانی
courage -> شجاعت
attract -> جذب کنند
bay -> خلیج
remove -> برداشتن
intense -> شدید، قوی
violence -> خشونت
heal -> شفا دادن
attempt -> تلاش
unfair -> غیر منصفانه
loyal -> وفادار
approach -> رویکرد
slowly -> به آرامی
normally -> به طور معمول
actor -> بازیگر
plain -> جلگه
attic -> اتاق زیر شیروانی
pet -> حیوان خانگی
threaten -> تهدید کند
motion -> حرکت - جنبش
collection -> مجموعه
incident -> حادثه
failure -> شکست
imagination -> خیال پردازی
counsellor -> مشاور
opposite -> مقابل
highest -> بالاترین
gross -> ناخالص
golden -> طلایی
badge -> نشان
italian -> ایتالیایی
visiting -> بازدید
studio -> استودیو
naturally -> به طور طبیعی
frozen -> منجمد
trunk -> تنه
armed -> مسلح
twisted -> پیچ خورده
costume -> لباس
temporary -> موقت
sixteen -> شانزده
zone -> منطقه
kitty -> بچه گربه
junk -> جنس اوراق و شکسته
honorary -> افتخاری
priest -> کشیش
cable -> کابل
affect -> تاثیر می گذارد
happily -> با خوشحالی
leading -> منتهی شدن
host -> میزبان
authority -> قدرت
commercial -> تجاری
admire -> تحسین
fund -> سرمایه
barn -> انبار غله
deeply -> عمیقا
wrapped -> پیچیده شده
tense -> زمان فعل
sport -> ورزش
route -> مسیر
plastic -> پلاستیک
election -> انتخابات
pierce -> سوراخ کردن
mortal -> فانی
fascinating -> شگفت انگیز
chosen -> انتخاب شده است
shown -> نشان داده شده
abandon -> رها کردن
china -> چین
arrangement -> ترتیب
agenda -> دستور جلسه
series -> سلسله
literally -> به معنای واقعی کلمه
propose -> پیشنهاد کند
honesty -> صداقت
basketball -> بسکتبال
underneath -> در زیر
soldier -> سرباز
review -> مرور
lecture -> سخنرانی
eighty -> هشتاد
brandy -> براندی
torn -> پاره شده
relief -> تسکین
golf -> گلف
counter -> پیشخوان
transfer -> منتقل کردن
response -> واکنش
channel -> کانال
backup -> پشتیبان گیری
identity -> هویت
differently -> متفاوت
spy -> جاسوسی
deck -> عرشه
biological -> بیولوژیکی
so -> بنابراین
minor -> جزئی
ease -> سهولت
creep -> خزیدن
will -> اراده
waitress -> پیشخدمت
skill -> مهارت
wave -> موج
thee -> تو
reception -> پذیرایی
pin -> سنجاق
diner -> غذاخوری
annoying -> مزاحم
goal -> هدف
council -> شورا
mass -> جرم
sergeant -> گروهبان
international -> بین المللی
gig -> کنسرت
blast -> انفجار
basic -> پایه ای
clown -> دلقک
rub -> مالیدن
customer -> مشتری
creature -> موجود
snap -> ضربه محکم و ناگهانی
prime -> نخست
handling -> رسیدگی
eaten -> خورده شده
therapist -> درمانگر
comment -> اظهار نظر
sink -> فرو رفتن
reporter -> خبرنگار
priority -> اولویت
gain -> کسب کردن
fed -> تغذیه شده است
warehouse -> انبار
virgin -> باکره
shy -> خجالتی
loyalty -> وفاداری
inspector -> بازرس
candle -> شمع
pleasant -> دلپذیر
media -> رسانه ها
castle -> قلعه
permanent -> دائمی
financial -> مالی
demand -> تقاضا
assault -> حمله
tend -> تمایل
motive -> انگیزه
unconscious -> ناخودآگاه
museum -> موزه
alley -> کوچه
swimming -> شنا کردن
nap -> چرت زدن
mysterious -> اسرار امیز
unhappy -> ناراضی
tone -> لحن
liberty -> آزادی
bang -> انفجار
award -> جایزه
cooper -> کوپر
childhood -> دوران کودکی
causless -> بی علت
sample -> نمونه
background -> زمینه
toss -> پرتاب کردن
mob -> اوباش
misery -> بدبختی
central -> مرکزی
boots -> چکمه
thief -> دزد
squeeze -> چلاندن، فشار دادن
lobby -> لابی
ego -> نفس
drama -> نمایش
noble -> نجیب
facing -> رو به رو
poker -> پوکر
cookie -> کوکی
digging -> حفر
creepy -> عجیب و غریب
comparable -> قابل مقایسه
trail -> دنباله
saint -> قدیس
rotten -> پوسیده
liver -> کبد
drawn -> کشیده شده
device -> دستگاه
magical -> جادویی
moral -> اخلاقی
attached -> پیوست شده است
searching -> جستجوکردن
flew -> پرواز کرد
depressed -> افسرده
aisle -> راهرو
underground -> زیرزمینی
pro -> حرفه ای
amen -> آمین
vow -> نذر
proposal -> پیشنهاد
pit -> گودال
darn -> لعنتی
clay -> خاک رس
arrange -> ترتیب دادن
annulment -> لغو
user -> کاربر
squad -> تیم
represent -> نمایندگی کند
product -> تولید - محصول
afterward -> پس از آن
adventure -> ماجرا
resist -> مقاومت کردن
piano -> پیانو
flag -> پرچم
debt -> بدهی
darkness -> تاریکی
violent -> خشن
tag -> برچسب زدن
strip -> نوار
hip -> باسن
celebration -> جشن
below -> زیر
paperwork -> کاغذبازی
mighty -> توانا
typical -> معمول
stable -> پایدار
pound -> پوند
pillow -> بالش
mature -> بالغ
lap -> دامان
current -> جاری
bum -> ماتحت
tension -> تنش
tank -> مخزن
stroke -> سکته
steady -> ثابت
overnight -> یک شبه
meanwhile -> در همین حال
chips -> چیپس
boxing -> مشت زنی
collect -> جمع آوری کنید
tragedy -> تراژدی
therefore -> از این رو
spoil -> از بین بردن
realm -> قلمرو
profile -> مشخصات
wipe -> پاک کن
surgeon -> جراح
stretch -> کش آمدن
neat -> مرتب
fox -> روباه
confident -> مطمئن
anti -> ضد
perspective -> چشم انداز
designer -> طراح
climb -> بالا رفتن
punishment -> مجازات
finest -> بهترین
hint -> اشاره
twist -> پیچ - پیچیدن
trigger -> ماشه
proceed -> ادامه دهید
lip -> لب
jersey -> پیراهن ورزشی
fries -> سیب زمینی سرخ شده
worries -> نگرانی ها
handy -> دستی
disappoint -> ناامید کردن
crawl -> خزیدن
convicted -> محکوم شد
lit -> روشن شد
flip -> تلنگر
counsel -> مشاوره
kit -> کیت
thick -> ضخیم
minister -> وزیر
jewellery -> جواهرات
goose -> غاز
average -> میانگین
creative -> خلاق
compliment -> تعریف و تمجید
cage -> قفس
wednesday -> چهار شنبه
burger -> برگر
seventeen -> هفده
menu -> منو
bean -> لوبیا
harbour -> بندرگاه
strategy -> استراتژی
similar -> مشابه
invent -> اختراع کردن
hood -> کاپوت ماشین
announce -> اعلام
slave -> برده
statue -> مجسمه
surrender -> تسلیم شدن
envelope -> پاكت نامه
sunshine -> آفتاب
potatoes -> سیب زمینیها
plea -> درخواست
side -> سمت
application -> کاربرد
random -> تصادفی
guitar -> گیتار
frog -> قورباغه
kidney -> کلیه
fog -> مه
hike -> پیاده روی
essay -> مقاله
fiancée -> نامزد
kindness -> مهربانی
elephant -> فیل
bush -> بوته
jeans -> شلوار جین
terror -> وحشت
november -> نوامبر
september -> سپتامبر
october -> اکتبر
pronounce -> تلفظ کنید
blink -> چشمک زدن
abroad -> خارج از کشور
absorb -> جذب
academic -> علمی
acceptable -> قابل قبول
accommodation -> محل اقامت
accompany -> همراهی کردن
achieve -> رسیدن
achievement -> دستاورد
acid -> اسید
adapt -> سازگار شدن
adequate -> کافی است
adjust -> تنظیم کنید
administration -> مدیریت
adopt -> اتخاذ کردن
advance -> پیشرفت
advertisement -> تبلیغات
advise -> توصیه
aggressive -> خشونت آمیز
agriculture -> کشاورزی
backwards -> به عقب
beforehand -> از قبل
behalf -> از طرف
beneath -> در زیر
bid -> پیشنهاد
bloke -> بلوک
boil -> جوشیدن
boiler -> دیگ بخار
border -> مرز
bounce -> جهش
branch -> شاخه
breast -> پستان
brick -> آجر
brief -> مختصر
briefly -> به طور خلاصه
broad -> گسترده
bump -> دست انداز
buyer -> خریدار
cabinet -> کابینه
calculate -> محاسبه
calendar -> تقویم
candidate -> نامزد
cap -> کلاه لبه دار
capacity -> ظرفیت
capture -> گرفتن
catalogue -> کاتالوگ
category -> دسته بندی
cease -> دست کشیدن
ceiling -> سقف
chairman -> رئيس هیئت مدیره
championship -> قهرمانی
chap -> فصل
chapter -> فصل
characteristic -> مشخصه
chart -> چارت سازمانی
cheek -> گونه
chemist -> شیمیدان
chemistry -> علم شیمی
clerk -> منشی
click -> کلیک
climate -> اقلیم
coal -> زغال سنگ
coin -> سکه
collapse -> سقوط - فروپاشی
collar -> یقه
colleague -> همکار
consent -> رضایت
daft -> دفت
daily -> روزانه
database -> پایگاه داده
debate -> مناظره
decade -> دهه
declare -> اعلام
decline -> کاهش می یابد
define -> تعریف کردن
definition -> تعریف
deliberately -> به عمد
democracy -> دموکراسی
demonstration -> تظاهرات
dentist -> دندانپزشک
departure -> عزیمت، خروج
dependent -> وابسته
deposit -> سپرده
depth -> عمق
derive -> استخراج
desire -> میل
detect -> تشخیص
determination -> عزم
diet -> رژیم غذایی
discipline -> انضباط
discount -> تخفیف
disk -> دیسک
dismiss -> رد
display -> نمایش دادن
economics -> اقتصاد
economy -> اقتصاد
edition -> نسخه
editor -> ویرایشگر
effective -> تاثير گذار
efficiency -> بهره وری
elderly -> مسن
electric -> برقی
electricity -> برق
elsewhere -> در جای دیگر
emerge -> ظهور
emphasis -> تاکید
empire -> امپراتوری
employer -> کارفرما
employee -> کارمند
encounter -> رویارویی
encourage -> تشويق كردن
engineer -> مهندس
enhance -> افزایش دهد
enormous -> عظیم
facility -> امکانات
factor -> عامل
factory -> کارخانه
feature -> ویژگی
feedback -> بازخورد
feeling -> احساس
fence -> حصار
festival -> جشنواره
fetch -> رفتن و آوردن
few -> تعداد کمی
filthy -> کثیف
flavour -> طعم و مزه
flood -> سیل
fold -> تا کردن
foreign -> خارجی
fork -> چنگال
formal -> رسمی
formally -> به طور رسمی
formation -> تشکیل
fortnight -> دو هفته
fortunate -> خوش شانس
foundation -> پایه
freeway -> آزادراه
freezer -> فریزر
frequently -> مکررا
fuel -> سوخت
function -> عملکرد
fundamental -> اساسی
fuss -> سر و صدا
gallery -> گالری
garlic -> سیر
gather -> جمع آوری
gear -> دنده
gene -> ژن
generally -> بطور کلی
generation -> نسل
gentle -> ملایم
genuine -> اصل
glance -> نگاه
global -> جهانی است
govern -> حکومت کنند
gradually -> به تدریج
grammar -> دستور زبان
graph -> نمودار
grass -> چمن
grocery -> خواربار
halfway -> نیمه راه
handbag -> کیف دستی
headquarter -> مقر
height -> ارتفاع
hence -> از این رو
hesitate -> تردید کنید
highlight -> برجسته
highway -> بزرگراه
historian -> تاریخ شناس
historical -> تاریخی
hold -> نگه دارید
holder -> دارنده
holding -> برگزاری
household -> خانواده
housing -> مسکن
heavily -> به شدت
ice cream -> بستنی
ideal -> ایده آل
identify -> شناسایی
illness -> بیماری
illustrate -> نشان دادن
impact -> تأثیر
implement -> پیاده سازی
implication -> پیامد
imply -> دلالت
import -> وارد كردن
impose -> تحمیل کند
improvement -> بهبود
improve -> بهتر کردن
income -> درآمد
independence -> استقلال
independent -> مستقل
index -> فهرست مطالب
individual -> شخصی
inevitably -> به ناچار
infant -> نوزاد
infection -> عفونت
inflation -> تورم
initial -> اولیه
initiative -> ابتکار عمل
innovation -> نوآوری
input -> ورودی
inquiry -> استعلام
install -> نصب
instance -> نمونه، مثال
instant -> فوری
instruction -> دستورالعمل
investment -> سرمایه گذاری
involvement -> درگیری
jumper -> جامپر
justify -> توجیه
luckily -> خوشبختانه
lounge -> سالن استراحت
limitation -> محدودیت
lighting -> روشنایی
locate -> پیدا کردن
mud -> گل و لای
motorway -> بزرگراه
mortgage -> رهن
moreover -> علاوه بر این
mobile phone -> تلفن همراه
mixture -> مخلوط
numerous -> متعدد
nuisance -> مزاحمت
nuclear -> هسته ای
nowadays -> این روزها
novel -> رمان
notion -> ایده
notably -> به ویژه
noisy -> پر سر و صدا
newly -> به تازگی
nevertheless -> با این اوصاف
objective -> هدف، واقعگرایانه
occasionally -> گاه و بیگاه
occupation -> اشتغال
opponent -> حریف
opposition -> مخالفت
ordinary -> معمولی
organ -> عضو
organic -> ارگانیک. آلی
organization -> سازمان
organize -> سازمان دادن
origin -> اصل و نسب
originally -> در اصل
outcome -> نتیجه
output -> خروجی
outstanding -> برجسته
oven -> فر
overall -> به طور کلی
overcome -> غلبه بر
overtime -> در طول زمان
owe -> مدیون
pursue -> دنبال کردن
purple -> رنگ بنفش
purely -> صرفا
purchase -> خرید
pudding -> پودینگ
publish -> انتشار
publicity -> تبلیغات
publication -> انتشار
psychology -> روانشناسی
psychological -> روانشناسی
provision -> تدارک
providing -> فراهم آوردن
protest -> اعتراض
prosecution -> پیگرد قانونی
proportion -> تناسب، قسمت
properly -> به درستی
prompt -> سریع
promotion -> ترویج
promote -> ترویج
profit -> سود
profession -> حرفه
producer -> تهیه کننده
produce -> تولید کردن
privilege -> امتیاز
prior -> قبل
printer -> چاپگر
principle -> اصل
principal -> اصلی
primary -> اولیه
previously -> قبلا
previous -> قبلی
prevent -> جلوگیری کردن
presumably -> احتمالا
preserve -> حفظ
presentation -> ارائه
preference -> ترجیح
precisely -> دقیقا
precise -> دقیق
prayer -> دعا
practical -> کاربردی
poverty -> فقر
pour -> ریختن
poster -> پوستر
possession -> مالکیت
possess -> در اختیار داشتن
pond -> حوضچه
pollution -> آلودگی
poll -> نظرسنجی
politics -> سیاست
pole -> قطب
poetry -> شعر
poet -> شاعر
plot -> طرح
platform -> سکو
pitch -> گام صدا
pipe -> لوله
pint -> پینت
pile -> توده
pill -> قرص
physics -> فیزیک
physically -> از نظر فیزیکی
phrase -> عبارت
photograph -> عکس
photocopy -> فتوکپی
philosophy -> فلسفه
phase -> فاز
persuade -> متقاعد کردن
permit -> مجوز
percentage -> درصد
perceive -> درک
peak -> اوج
peaceful -> صلح آمیز
quote -> نقل قول
racing -> مسابقه
radical -> افراطی
rapidly -> به طور سریع
ratio -> نسبت
raw -> خام
reader -> خواننده
readily -> به راحتی
realistic -> واقع بین
recipe -> دستور آشپزی
reckon -> حساب کنید
recommend -> توصیه
recover -> بهبود می یابند
reduction -> کاهش
refer -> مراجعه کنید
reflect -> منعکس کنند
reform -> اصلاح
regard -> توجه
regime -> رژیم
regularly -> به طور منظم
reject -> رد کردن
relate -> مربوط بودن
relation -> رابطه
relative -> نسبت فامیلی
relieve -> از بین بردن
religion -> دین
remark -> تذکر
reserve -> ذخیره
resort -> رفت و آمد مکرر
resource -> منبع
respond -> پاسخ دادن
restore -> بازگرداندن
restrict -> محدود کردن
restriction -> محدودیت
retire -> بازنشسته شدن
reveal -> آشکار کردن
revolution -> انقلاب
sack -> گونی
scientific -> علمی
scope -> محدوده
secondly -> دوما
seize -> تصاحب کردن
selection -> انتخاب
sharply -> به شدت
shave -> تراشیدن
shell -> پوسته
shelter -> پناه
shine -> درخشیدن
shortly -> به زودی
should -> باید
shove -> تنه زدن
shrug -> شانه بالا انداختن
similarly -> به طور مشابه
sin -> گناه
skirt -> دامن
slide -> اسلاید
slight -> اندک
slightly -> اندکی
slope -> شیب
sock -> جوراب
soil -> خاک
spray -> افشانه
starve -> گرسنگی
status -> وضعیت
steel -> فولاد
storage -> ذخیره سازی
strain -> نژاد
straw -> پوشال
stream -> جریان
strongly -> به شدت
structure -> ساختار
substance -> ماده
succeed -> موفق شدن
sufficient -> کافی
surprising -> شگفت آور
surround -> احاطه
survey -> نظر سنجی
survival -> بقا
suspicion -> سوء ظن
swap -> مبادله
sympathy -> ابراز همدردی
tendency -> گرایش
tent -> چادر
tidy -> مرتب
tin -> قلع
ton -> تن
trend -> روند
tricky -> روی حیله و تزویر
tune -> اهنگ
tunnel -> تونل
tyre -> لاستیک
ultimate -> نهایی
understanding -> فهم
unemployed -> بیکار
unfortunate -> مایه تاسف
unique -> منحصر بفرد
unknown -> ناشناس
upper -> بالا
urban -> شهری
urge -> اصرار
urgent -> فوری
used -> استفاده شده
valuable -> با ارزش
various -> مختلف
vehicle -> وسیله نقلیه
virtually -> به صورت مجازی
virtue -> تقوا
visible -> قابل رویت
visitor -> بازدید کننده
vital -> حیاتی
voluntary -> داوطلبانه
withdraw -> کنار کشیدن
widespread -> بطور گسترده
widely -> به طور گسترده ای
whisper -> نجوا
youngster -> جوان
gut -> روده
crocodile -> تمساح
dialect -> گویش
e-book -> کتاب الکترونیکی
hearty -> دلچسب
incurable -> غیر قابل درمان
jockey -> جوکی
junk food -> غذای آشغال
mania -> شیدایی
margarine -> مارگارین
mosque -> مسجد
preposition -> حرف اضافه
proclaim -> اعلام
shiver -> لرزیدن
skilful -> ماهر
socket -> سوکت
sportsman somewhere -> ورزشکار در جایی
sweetheart -> عزیزم
amazing -> شگفت انگيز
definitely -> قطعا
evidence -> شواهد و مدارک
upstairs -> از پله ها
dangerous -> خطرناک
innocent -> بی گناه
apparently -> ظاهرا
congratulations -> تبریک می گویم
experience -> تجربه
medical -> پزشکی
incredible -> باور نکردنی
attorney -> وکیل
jealous -> حسود
ourselves -> خودمان
unfortunately -> متاسفانه
whenever -> هر زمان که
pathetic -> تأسفبار - رقت انگیز
downstairs -> طبقه پایین
immediately -> بلافاصله. مستقیما
gorgeous -> جذاب
physical -> فیزیکی
garbage -> زباله
coincidence -> اتفاقی
generous -> سخاوتمندانه
outfit -> لباس
suspicious -> مشکوک
anniversary -> سالگرد
commitment -> تعهد
challenge -> چالش
discussion -> بحث
younger -> جوان تر
romance -> داستان عاشقانه
procedure -> روش
medication -> دارو
shared -> به اشتراک گذاشته شده است
warrant -> حکم
odds -> شانس
specific -> خاص
sweater -> ژاکت
diagram -> نمودار
jet -> جت
vulnerable -> آسیب پذیر
tears -> اشک
locker -> قفسه
awkward -> بی دست و پا - به شکلی نامناسب
delicious -> خوشمزه - لذیذ
murderer -> قاتل
technically -> از نظر فنی
cave -> غار
performance -> کارایی
gram -> گرم
touching -> لمس کردن
committee -> کمیته
consequence -> نتیجه
testimony -> شهادت
granted -> اعطا شده
political -> سیاسی
equipment -> تجهیزات
appropriate -> مناسب
impressive -> چشمگیر
intelligence -> هوش
questioning -> سوال کردن
campus -> محوطه دانشگاه
hallway -> راهرو
popcorn -> ذرت بو داده
makeup -> آرایش
madam -> خانم
jean -> جین
cowboy -> گاوچران
blackmail -> باج گیری
concept -> مفهوم
barb -> خار
supportive -> حمایت کننده
memorial -> یادبود
japanese -> ژاپنی
explosion -> انفجار
trauma -> ضربه
russian -> روسی
furious -> خشمگین
cheat -> تقلب
approve -> تایید
drawer -> کشو
phony -> ساختگی
joining -> پیوستن
interfere -> مداخله کردن
governor -> فرماندار
catching -> گرفتن
bargain -> چانه زدن
tragic -> غم انگیز
punish -> تنبیه کردن
hop -> هاپ
rich -> ثروتمند
insult -> توهین
absolute -> مطلق
strictly -> موکدا
british -> بریتانیایی
worthy -> شایسته
serving -> خدمت کردن
polite -> با ادب
internal -> درونی؛ داخلی
bitter -> تلخ
adorable -> شایان ستایش
alike -> یکسان
fax -> فکس
distracted -> پریشان
escort -> اسکورت
twin -> دوقلو
circus -> سیرک
audition -> آزمون
mask -> ماسک
helpless -> درمانده
dated -> تاریخ دار
robbery -> سرقت
beast -> جانور
tub -> وان
talented -> با استعداد
struck -> رخ داد
mistaken -> اشتباه کرد
italy -> ایتالیا
bizarre -> عجیب و غریب
scaring -> ترساندن
punk -> پانک
focused -> متمرکز شده است
alert -> هشدار
activity -> فعالیت
foolish -> احمقانه
attend -> مراجعه كردن
canadian -> کانادایی
aid -> کمک
wheelchair -> ویلچر
protective -> محافظ
picnic -> پیک نیک
construction -> ساخت و ساز
wives -> همسران
stink -> بوی تعفن
recent -> اخیر
jewish -> یهودی
filling -> پر كردن
exit -> خروج
cruise -> کشتی تفریحی
cottage -> کلبه
corporate -> شرکت های بزرگ، دارای شخصیت حقوقی
upside -> وارونه
german -> آلمانی
basis -> اساس
wounded -> مجروح
conformity -> مطابقت
wicked -> شریر
merely -> صرفا - فقط
massage -> ماساژ دادن
chop -> تکه کردن
costs -> هزینه ها
betray -> خیانت کردن
waiter -> گارسون
scam -> کلاهبرداری
fraud -> تقلب
flu -> آنفولانزا
pee -> ادرار
cliff -> صخره
expression -> اصطلاح
entrance -> ورود
drawing -> طراحی
bunny -> خرگوش کوچک
bracelet -> دستبند
thirteen -> سیزده
scout -> دیده بانی
fairly -> منصفانه
arrive -> رسیدن
shed -> دهنه
nanny -> پرستار بچه
naive -> آدم ساده
corn -> ذرت
authorities -> مسئولین
separated -> جدا از هم
patch -> پچ
devastated -> ویران
description -> شرح
subtle -> نامحسوس
garrison -> پادگان
metal -> فلز
executive -> اجرایی
confirm -> تایید
parade -> رژه
bow -> تعظیم
booth -> غرفه
straighten -> راست کردن
honoured -> مفتخر شد
specifically -> به طور مشخص
exam -> امتحان
convenient -> راحت
traveling -> مسافرت
laying -> تخمگذار
crystal -> کریستال
apply -> درخواست دادن
air -> هوا
legend -> افسانه
kindly -> محبت آمیز
grandson -> نوه پسر
donor -> اهدا کننده
temper -> خلق و خوی
proven -> ثابت شده است
monitor -> نظارت کنید
eternity -> ابدیت
denial -> انکار
swell -> متورم شدن
noon -> ظهر
episode -> قسمت
thinking -> فكر كردن
spirits -> ارواح
potion -> معجون
dial -> شماره گیری کنید
rehearsal -> مشق
hostage -> گروگان
hammer -> چکش
facet -> جنبه
discover -> کشف کردن
constant -> مقدار ثابت
bench -> نیمکت
moron -> احمق
impress -> تاثیر گذاشتن
gray -> خاکستری
entitled -> تحت عنوان
connect -> اتصال
needle -> سوزن
lad -> پسر
intelligent -> باهوش
disagree -> مخالف بودن
tiger -> ببر
groom -> داماد
gesture -> ژست
developed -> توسعه یافته
constantly -> دائما
sealed -> مهر و موم شده
paradise -> بهشت
legally -> به صورت قانونی
psychic -> روانی
dense -> متراکم
teenage -> نوجوان
rabbit -> خرگوش
puppy -> توله سگ
bible -> کتاب مقدس
accidentally -> به طور تصادفی
superior -> برتر
slack -> سستی
homeless -> بی خانمان
hollow -> توخالی
desperately -> ناامیدانه
critical -> بحرانی
coward -> ترسو
personnel -> پرسنل
item -> مورد
due -> ناشی از
majesty -> عظمت
jay -> جی
instinct -> غریزه
extreme -> مفرط
belief -> باور
motorcycle -> موتورسیکلت
convincing -> متقاعد کننده
appeal -> درخواست
greater -> بزرگتر
aids -> ایدز
grip -> گرفتن
upsetting -> ناراحت کننده
production -> تولید
invisible -> نامرئی
forgiveness -> بخشش
complex -> مجتمع
compare -> مقایسه کنید
blank -> جای خالی
treasure -> گنج
sacred -> مقدس
inviting -> دعوت کردن
inner -> درونی
compromise -> به خطر افتادن
cocktail -> کوکتل
tramp -> با صدا راه رفتن
signing -> امضا کردن
messenger -> پیام رسان
landing -> فرود آمدن
intimate -> صمیمی
dignity -> کرامت
dealt -> معامله شد
root -> ریشه
entertainment -> سرگرمی
dressing -> تزئین
blessing -> برکت
billion -> میلیارد
lightning -> رعد و برق
leak -> نشت
fond -> دوست داشتنی
corky -> چوب پنبه ای
alternative -> جایگزین
seduce -> از راه بدر کردن
modern -> نوین
liquor -> مشروب
june -> ژوئن
stuffed -> پر شده
emotionally -> از نظر احساسی
division -> تقسیم
conditions -> شرایط
transplant -> پیوند
tips -> نکات
powder -> پودر
oxygen -> اکسیژن
lunatic -> دیوانه
hid -> پنهان کرد
drill -> مته
complain -> شكايت كردن
announcement -> اعلامیه
slap -> سیلی زدن
pumpkin -> کدو تنبل
oath -> سوگند - دشنام
mutual -> متقابل
hockey -> هاکی
graduate -> فارغ التحصیل
yacht -> قایق بادبانی
spa -> آبگرم
horn -> شیپور
fried -> سرخ شده در روغن
extraordinary -> خارق العاده
bait -> طعمه
appearance -> ظاهر
sworn -> قسم خورده
safely -> بدون خطر
reunion -> تجدید دیدار
burst -> ترکیدن
experiment -> آزمایش
explicit -> صریح
dive -> شیرجه رفتن
commission -> کمیسیون
chaos -> آشوب
aboard -> در کشتی
lesbian -> لزبین
expose -> در معرض گذاشتن
environment -> محیط
spider -> عنکبوت
smaller -> کوچکتر
booze -> مشروب الکلی
tattoo -> خال کوبی
parole -> آزادی مشروط
ditch -> گودال
bulldog -> بولداگ
bra -> سینه بند
spanish -> اسپانیایی
glow -> درخشش
thirsty -> تشنه
skull -> جمجمه
scotch -> اسکاچ
dining -> ناهار خوری
bend -> خم شدن
unexpected -> غیر منتظره
sob -> هق هق
pancake -> پنکیک
harsh -> خشن
existence -> وجود داشتن
troubles -> مشکلات
favourite -> مورد علاقه
driven -> رانده
chin -> چانه
rage -> خشم
bubble -> حباب
undercover -> مخفی
spoiled -> خراب
rug -> قالیچه
deputy -> قائم مقام
conspiracy -> توطئه
clothing -> تن پوش
thoughtful -> متفکر
drank -> نوشیدند
contrary -> مخالف
beloved -> محبوب
allergic -> حساسیتی
forgiven -> بخشیده شد
earl -> ارل
bent -> خم شده
approval -> تصویب
jungle -> جنگل
dancer -> رقصنده
cotton -> پنبه
cooked -> پخته شده
foul -> ناپاک
dull -> کدر
peanut -> بادام زمینی
horror -> وحشت
stunt -> شیرین کاری
portrait -> پرتره
july -> جولای
jealousy -> حسادت
hopeless -> نومید
volunteer -> داوطلب
sword -> شمشیر
scenario -> سناریو
necklace -> گردن بند
chapel -> نمازخانه
restrain -> مهار کردن
homicide -> قتل
helicopter -> بالگرد
firing -> شلیک کردن
safeguard -> حفاظت
diamond -> الماس
devoted -> اختصاص داده شده است
auction -> حراج
videotape -> نوار ویدئویی
tore -> پاره کردند
pops -> ظاهر می شود
appetite -> اشتها، میل
patrol -> گشت
ironic -> کنایه آمیز
excitement -> هیجان
anyhow -> در هر صورت
core -> هسته
bowling -> بولینگ
belly -> شکم
shark -> کوسه
miller -> آسیاب
dealer -> فروشنده - دلال
cooperate -> همکاری کردن
bachelor -> عزب
accomplish -> انجام دهد
reservation -> رزرو
coke -> کک
ashes -> خاکستر
supposedly -> ظاهرا
loft -> زیر شیروانی
integrity -> تمامیت
qualified -> واجد شرایط
inappropriate -> نامناسب
immediate -> فوری
ginger -> زنجبیل
sunset -> غروب آفتاب
nation -> ملت
lipstick -> رژ لب
lawn -> چمن
compassion -> رحم و شفقت - دلسوزی
cafeteria -> کافه تریا
scarf -> روسری
obsession -> وسواس
management -> مدیریت
lighten -> سبک کردن
granddaughter -> نوه
explode -> منفجر شود
balcony -> بالکن
conscious -> هوشیار، آگاه
ally -> متحد
ace -> آس
absurd -> چرند
vicious -> شریر، بدجنس، حیوان صفت
rap -> رپ
forbid -> منع
defendant -> مدافع
bare -> برهنه
salesman -> فروشنده
leap -> جهش
ken -> کن
insanity -> جنون
genetic -> ژنتیکی
fighter -> جنگنده
burden -> بار
swallow -> بلع
kidnap -> ادم دزدی کردن
gown -> لباس شب
entering -> ورود
setup -> برپایی
serial -> سریال
sandy -> شنی
dramatic -> نمایشی
carver -> منبت کار
blade -> تیغه
seventh -> هفتم
rape -> تجاوز جنسی
pony -> تسویه حساب
semester -> نیمسال
delicate -> ظریف
oldest -> قدیمی ترین
live -> زنده
eager -> مشتاق
doomed -> محکوم به فنا
coffin -> تابوت
bureau -> دفتر
adoption -> فرزندخواندگی
stab -> چاقو زدن
sickness -> بیماری
loop -> حلقه
floating -> شناور
combination -> ترکیبی
chamber -> محفظه - اتاق
casino -> کازینو
worn -> پوشیده
vault -> طاق
payback -> بازپرداخت
healing -> شفا
cascade -> آبشار
wrestling -> کشتی
sixth -> ششم
passionate -> پرشور
lawsuit -> طرح دعوی در دادگاه
distrustul -> بی اعتمادی
crossing -> عبور از
cozy -> دنج
associate -> وابسته
tire -> لاستیک
mill -> کارخانه
journal -> مجله
risky -> مخاطره آمیز
nest -> لانه
honourable -> محترم
favour -> لطف
culture -> فرهنگ
closest -> نزدیکترین
breakdown -> درهم شکستن
conflict -> تعارض
bald -> بدون مو
actress -> بازیگر
wisdom -> خرد
steam -> بخار
scar -> جای زخم
worthless -> بی ارزش
suck -> مکیدن
injured -> مجروح
graduation -> فارغ التحصیلی
disturbing -> مزاحم
disturb -> مزاحم
distract -> حواس پرت کردن
conclusion -> نتیجه
baker -> نانوا
muffin -> کلوچه
mid -> اواسط
measure -> اندازه گرفتن
crawling -> خزیدن
congress -> کنگره
briefcase -> کیف
whistle -> سوت زدن
roast -> کباب
greek -> یونانی
flirting -> معاشقه
damaged -> آسیب دیده
topic -> موضوع
riot -> شورش
minimum -> کمترین
hostile -> خصومت آمیز
embarrass -> شرم آور
casual -> گاه به گاه
beacon -> فانوس دریایی
amusing -> سرگرم کننده
altar -> محراب
skinny -> لاغر
goods -> کالاها
porch -> ایوان
ghost -> روح
drops -> قطره می کند
dizzy -> سرگیجه
breastfeeding -> شیر دادن
beaten -> مورد ضرب و شتم
rehabilitation -> توانبخشی
photographer -> عکاس
leery -> پرخاشگر
fortunately -> خوشبختانه
expectation -> انتظار
draft -> پیش نویس
active -> فعال
ski -> اسکی
musician -> نوازنده
executed -> اجرا شده
examine -> معاینه کردن
document -> سند
bribe -> رشوه دادن
rum -> رام
prescription -> نسخه
hush -> ساکت کردن
fuzzy -> درهم
fragile -> شکننده
forensics -> پزشکی قانونی
expense -> هزینه
drugged -> مصرف مواد مخدر
conduct -> هدایت
comic -> کمیک
avenue -> خیابان
suitcase -> چمدان
sort -> مرتب سازی
scan -> اسکن کنید
rod -> میله
motor -> موتور
mini -> مینی
installation -> نصب و راه اندازی
insecure -> ناامن
gamble -> قمار
wrist -> مچ دست
silk -> ابریشم
pump -> پمپ
nicer -> زیباتر
haul -> حمل و نقل
guardian -> نگهبان
dodge -> طفره رفتن
boot -> چکمه
thumb -> شست
limited -> محدود
lighter -> فندک
elder -> بزرگتر
shooter -> تیرانداز
quietly -> بی سر و صدا
lion -> شیر نر
erase -> پاک کردن
denying -> انکار کردن
ankle -> مچ پا
amnesia -> فراموشی
ruby -> یاقوت سرخ
hunter -> شکارچی
heartbeat -> تپش قلب
confront -> مواجه شدن
minus -> منهای
legitimate -> مشروع
hurricane -> طوفان
fixing -> تثبیت
auto -> خودکار
arrogant -> مغرور
tuna -> ماهی تن
slightest -> کوچکترین
saying -> گفتن
paternity -> پدری
catholic -> کاتولیک
snack -> خوراک مختصر
rational -> گویا
passport -> گذرنامه
dip -> شیب
advanced -> پیشرفته
tumor -> تومور
humiliated -> تحقیر شده
destruction -> تخریب
banana -> موز
august -> اوت
aspirin -> آسپرین
academy -> آکادمی
wig -> کلاه گیس
turk -> ترک
throughout -> در سراسر
logic -> منطق
knight -> شوالیه
eyesight -> بینایی
equal -> برابر
ritual -> مراسم
perfume -> عطر
hiring -> استخدام
ham -> ژامبون
fusion -> ذوب
elect -> برگزیدن
thankful -> سپاسگزار
nineteen -> نوزده
comedy -> کمدی
analysis -> تحلیل و بررسی
teenager -> نوجوان
shore -> ساحل
palm -> نخل
detective -> کاراگاه
widow -> بیوه
tissue -> بافت
repay -> بازپرداخت
permanently -> به طور دائم
hack -> هک کردن
deadly -> مرگبار
comfortless -> راحت
verdict -> حکم
jar -> شیشه
insensitive -> غیر حساس
aim -> هدف
triple -> سه گانه
messy -> بی نظم
entry -> ورود
bleed -> خونریزی
foster -> پرورش دادن، پروردن
ding -> دینگ
airplane -> هواپیما
worker -> کارگر
underestimate -> دست کم گرفتن
soccer -> فوتبال
registered -> ثبت شده است
multiple -> چندگانه
harmless -> بی ضرر
frisk -> دمدمی مزاج
folk -> مردم
convention -> قرارداد
communicate -> برقراری ارتباط
attraction -> جاذبه
arson -> آتش زدن
whack -> ضربت زدن
wade -> وید
residence -> محل سکونت
medium -> متوسط
liking -> دوست داشتن
development -> توسعه
develop -> توسعه دهد
dearest -> عزیزترین
congratulate -> تبریک گفتن
april -> آوریل
alliance -> اتحاد
vengeance -> انتقام گرفتن
rack -> دندانه دار کردن
puzzle -> پازل
guidance -> راهنمایی
courtesy -> حسن نیت
caller -> تماس گیرنده
wizard -> جادوگر
repair -> تعمیر
quiz -> مسابقه
curiosity -> کنجکاوی
barbecue -> باربیکیو
troops -> نیروهای
cough -> سرفه کردن
accusation -> اتهام
resent -> کینه توز
freshman -> دانشجوی سال اول
envy -> حسادت
drown -> غرق شدن
sofa -> کاناپه
highness -> عظمت
drain -> زه کشی
dock -> بارانداز
welfare -> رفاه
theirs -> آنها
state -> حالت
somewhat -> تاحدی
solo -> انفرادی
jazz -> جاز
hawk -> شاهین
finishing -> به پایان رساندن
album -> آلبوم
wee -> کوچولو
understandable -> قابل درک
stir -> هم بزنید
gratitude -> حق شناسی
faithful -> با ایمان
accent -> لهجه
zip -> زیپ
wandering -> سرگردان
regardless -> بدون در نظر گرفتن
inevitable -> اجتناب ناپذیر
crushed -> خرد شده
contingent -> مشروط
rocky -> سنگی
robe -> لباس بلند و گشاد
retired -> بازنشسته
gossip -> شایعات
gambling -> قمار
determine -> تعیین کنید
cosmetics -> لوازم آرایشی
cent -> سنت
stiff -> سفت
sincere -> مخلص - بی ریا - صمیمانه
shield -> سپر
nightmare -> کابوس
ignoring -> نادیده گرفتن
hunch -> قوز کردن
firework -> آتش بازی
crown -> تاج پادشاهی
cooperation -> مشارکت
brass -> برنجی
sophisticated -> پیچیده
luggage -> بار مسافر
lemon -> لیمو
investigate -> تحقیق کردن
explore -> کاوش
dragon -> اژدها
creek -> نهر
complication -> عوارض
righteous -> عادل
reconsider -> تجدید نظر کند
inspiration -> الهام گرفتن
goody -> خوب
fringe -> حاشیه
ethic -> اخلاق
courthouse -> دادگاه
camping -> چادر زدن
assistance -> معاونت
affection -> محبت
lodge -> کلبه
haircut -> اصلاح مو
forcing -> مجبور کردن
eternal -> ابدی
stud -> گل میخ
sailor -> ملوان
operator -> اپراتور
goat -> بز
exclusive -> انحصاری
destructive -> مخرب
defeat -> شکست
adore -> عشق ورزیدن
warrior -> جنگجو
shorts -> شلوار کوتاه
ninth -> نهم
dough -> خمیر
creation -> ایجاد
barrel -> بشکه
tuck -> چفت کردن
rear -> عقب
pacific -> صلح جو
magnificent -> باشکوه
lick -> لیسیدن
goddess -> الهه
glorious -> با شکوه
visitation -> بازدید
teen -> نوجوان
scholarship -> بورس تحصیلی
sane -> عاقل
kingdom -> پادشاهی
flames -> شعله های آتش
sunny -> آفتابی
mattress -> تشک
lobster -> خرچنگ
importantly -> مهم است
glove -> دستکش
disappointment -> ناامیدی
condo -> کاندو
cemetery -> قبرستان
screech -> جیغ
nun -> راهبه
navy -> نیروی دریایی
dedicated -> اختصاصی
christian -> مسیحی
annual -> سالانه
worm -> کرم
tick -> تیک بزنید
polish -> لهستانی
funds -> منابع مالی
defensive -> دفاعی
compete -> رقابت کنند
balloon -> بالون
sailing -> کشتیرانی
filing -> تشکیل پرونده
depression -> افسردگی
conversation -> گفتگو
consideration -> توجه
consciousness -> آگاهی
innocence -> بی گناهی
freaky -> دمدمی مزاج
forehead -> پیشانی
slam -> ضربه زدن
pry -> کنجکاوی
inform -> آگاه کردن
dug -> حفر کرد
delighted -> خوشحال
daylight -> نور روز
currently -> در حال حاضر
confidential -> محرمانه
chew -> جویدن
washing -> شستشو
warden -> نگهبان
temple -> معبد
mistress -> معشوقه
marrow -> مغز
hatred -> نفرت
grill -> کباب
corpse -> جسد
sober -> هوشیار
peel -> پوست کندن
larger -> بزرگتر
infected -> مبتلا شده
humanity -> بشریت
electrical -> برقی
distraction -> حواس پرتی
chopper -> خردکن
cart -> سبد خرید
broadcast -> پخش
violation -> نقض
suspend -> تعلیق کند
sting -> نیش
promising -> امیدوار کننده
harassment -> آزار و اذیت
glue -> چسب
gathering -> جمع آوری
deer -> آهو
cursed -> نفرین شده
content -> محتوا
combat -> مبارزه کن
brutal -> وحشیانه
asset -> دارایی
warlock -> جنگجو
wagon -> واگن
unpleasant -> ناخوشایند
tan -> برنزه
robot -> ربات
lease -> اجاره
killer -> قاتل
flame -> شعله
domestic -> داخلی
divine -> الهی
disappearance -> ناپدید شدن
depressing -> افسرده کننده
thrill -> هیجان
terminal -> پایانه
rib -> دنده
knew -> می دانست
flush -> فلاش
exception -> استثنا
earring -> گوشواره
deadline -> ضرب الاجل
corporal -> سرجوخه
update -> به روز رسانی
smack -> بو
melt -> ذوب شدن
madness -> جنون
eagle -> عقاب
delusional -> متوهم
could -> میتوانست
burnt -> سوخته
tender -> مناقصه
sperm -> اسپرم
realise -> پی بردن
pork -> گوشت خوک
interrogation -> بازجویی
institution -> موسسه، نهاد
esteem -> احترام
communication -> ارتباط
choir -> گروه کر
undo -> لغو کردن
plague -> طاعون
manipulate -> دستکاری کردن
lifestyle -> سبک زندگی
insulting -> توهین آمیز
honour -> افتخار و احترام
detention -> بازداشت
delightful -> لذت بخش
daisy -> دیزی
coffeehouse -> قهوه خانه
chess -> شطرنج
betrayal -> خیانت
apologizing -> عذرخواهی
whipped -> شلاق خورده
reminder -> یادآور
fame -> شهرت
faint -> از هوش رفتن
confusion -> گیجی
sang -> آواز خواند
nearest -> نزدیکترین
illusion -> توهم
execution -> اعدام
distress -> پریشانی
cutter -> کاتر
correctly -> به درستی
complaint -> شکایت
trophy -> جام
pointless -> بیهوده
pearl -> مروارید
heir -> وارث
eighth -> هشتم
alibi -> علیبی
shiny -> براق
mint -> نعناع
keeper -> نگهبان
hose -> شلنگ
hobby -> سرگرمی
fitting -> مناسب
curtain -> پرده
counselling -> مشاوره
wit -> بذله گویی
technical -> فنی
puppet -> عروسک خیمه شب بازی
modeling -> مدل سازی
irresponsible -> بی مسئولیت
humiliation -> حقارت
felony -> جنایت
choke -> خفه کردن
blackmailing -> باج خواهی
tabloid -> تبلوید
rally -> تجمع
pledge -> سوگند - تعهد
nursery -> مهد کودک
louder -> بلندتر
investigator -> محقق
ignate -> مشتعل کردن
homecoming -> بازگشت به خانه
graduated -> فارغ التحصیل شد
frustrating -> خسته کننده، اذیت کننده
fabric -> پارچه
dot -> نقطه
distant -> غیر صمیمی
cock -> خروس
bustle -> شلوغی
buff -> گاومیش
wax -> موم
sleeve -> آستین
irony -> کنایه
dope -> پیش بینی کردن
torch -> مشعل
substitute -> جایگزین
scandal -> رسوایی
prick -> نیش زدن
limb -> اندام
laser -> لیزر
hysterical -> هیستریک
growth -> رشد
dimension -> بعد، ابعاد، اندازه
clip -> کلیپ
climbing -> سنگ نوردی
ultimately -> در نهایت
roller -> غلتک
negotiate -> مذاکره کنند
millennium -> هزاره
marsh -> مرداب
majority -> اکثریت
lethal -> مرگبار
deed -> سند - سند قانونی
cigar -> سیگار برگ
bore -> منفذ
babysitter -> پرستار بچه
sponge -> اسفنج
sleepy -> خواب آلود
peek -> زیرچشمی نگاه کردن
outrageous -> ظالمانه
medal -> مدال
grudge -> کینه
driveway -> راهرو
deserted -> متروک
definite -> قطعی
beep -> بوق
weed -> علف هرز
nickname -> نام مستعار
conviction -> محکومیت
weigh -> وزن کردن
rocket -> موشک
intruder -> مزاحم
fur -> خز
herb -> گیاه دارویی
cycle -> چرخه
hardware -> سخت افزار
wealthy -> ثروتمند
versus -> در مقابل
sip -> جرعه جرعه
postpone -> عقب انداختن
celebrity -> فرد مشهور
offensive -> توهین آمیز
mug -> لیوان
hairy -> مودار
bedtime -> زمان خواب
alcoholic -> الکلی
sticky -> چسبنده
splendid -> عالی
shrimp -> میگو
despise -> خوار شمردن
atmosphere -> جو
rifle -> تفنگ
handwriting -> دست خط
shepherd -> شبان
importance -> اهمیت
fatal -> کشنده
separation -> جدایش، جدایی
method -> روش
diagnosis -> تشخیص
yearbook -> سالنامه
triangle -> مثلث
partnership -> شراکت
humble -> فروتن
thorough -> کامل
thunder -> رعد و برق
located -> واقع شده
grandchildren -> نوه ها
sentimental -> احساساتی
marketing -> بازار یابی
population -> جمعیت
scent -> رایحه
pose -> ژست
fleet -> ناوگان
sketch -> طرح
mere -> صرف
outer -> بیرونی
mock -> مسخره کردن
january -> ژانویه
sour -> ترش
maximum -> بیشترین
speaker -> گوینده
tease -> اذیت کردن
peach -> هلو
nude -> برهنه
clearance -> ترخیص کالا از گمرک
anxiety -> اضطراب
salmon -> ماهی سالمون
summit -> اجلاس - همایش
lid -> درب
mechanic -> مکانیک
tobacco -> تنباکو
missile -> موشک
steer -> هدایت کردن
heel -> پاشنه
granddad -> پدربزرگ
tournament -> مسابقات
approximately -> تقریبا
employment -> استخدام
grandparents -> پدربزرگ و مادربزرگ
forbidden -> ممنوع
tutor -> معلم خصوصی
modest -> فروتن
vessel -> کشتی
variety -> تنوع
smash -> درهم کوبیدن
mild -> خفیف
shaft -> شفت
rainbow -> رنگین کمان
grasp -> فهم
fireplace -> بخاری
tide -> جزر و مد
mustard -> خردل
wheat -> گندم
fountain -> آبنما
stem -> ساقه
december -> دسامبر
writer -> نویسنده
tribe -> قبیله
ounce -> اونس
convenience -> راحتی
dash -> خط تیره
invest -> سرمایه گذاری
difficulty -> دشواری
sadness -> غمگینی
microwave -> مایکروویو
additional -> اضافی
mankind -> بشر
fare -> کرایه
laptop -> لپ تاپ
saddle -> زین اسب
razor -> تیغ
coverage -> پوشش
corridor -> راهرو
sidewalk -> پیاده رو
oak -> بلوط
notify -> مطلع ساختن
confide -> رام کن
scrub -> اسکراب
parallel -> موازی
orbit -> مدار
feather -> پر
farmer -> مزرعه دار
spicy -> تند
napkin -> دستمال سفره
efficient -> کارآمد
arrow -> فلش
abbey -> صومعه
solitary -> منفرد، مجد، تنها، منزوی، انفرادی
myth -> اسطوره
toll -> عوارض
fuse -> فیوز
industrial -> صنعتی
hostess -> مهماندار
delight -> لذت بسیار
imaginary -> خیالی
elegant -> ظریف
elbow -> آرنج
custom -> سفارشی
ant -> مورچه
tempt -> دچار وسوسه کردن
splash -> پاشیدن
shade -> سایه
metaphor -> استعاره
ancestor -> جد
acceptance -> پذیرش - پذیرفته شدن
weekly -> هفتگی
warmth -> گرما
umbrella -> چتر
parenting -> فرزندپروری
onion -> پیاز
mobile -> سیار
footstep -> قدم گذاشتن
cement -> سیمان
bloom -> شکوفه
triumph -> پیروزی
greed -> طمع
essential -> ضروری است
temptation -> وسوسه
sarcasm -> طعنه
partial -> جزئي
inconvenience -> ناراحتی
courageous -> شجاع
stew -> خورشت
sorrow -> غم و اندوه
mend -> بهبودی یافتن
impulsive -> تکانشی
harvest -> محصول
foam -> فوم
divide -> تقسیم کنید
online -> برخط
invasion -> تهاجم
consultant -> مشاور
banking -> بانکداری
stereo -> استریو
obey -> اطاعت کن
neutral -> خنثی
lump -> توده
harass -> آزار دادن
donkey -> الاغ
cologne -> ادکلن
waist -> کمر
vain -> بیهوده
stepfather -> پدر خوانده
lemonade -> لیموناد
vomit -> استفراغ
stadium -> استادیوم
liberal -> لیبرال
spice -> ادویه
nod -> سر تکان دادن
tenth -> دهم
horizon -> افق
frequency -> فرکانس
flexible -> قابل انعطاف
dairy -> لبنیات
corrupt -> فاسد
loaf -> قرص نان
herbal -> گیاهی
generosity -> سخاوت
shampoo -> شامپو
humour -> شوخ طبعی
frost -> سرمازدگی
volcano -> آتشفشان
password -> کلمه عبور
merit -> شایستگی
conquer -> تسخیر
orientation -> گرایش
lotion -> لوسیون
hazard -> خطر
glamorous -> فریبنده
scenery -> منظره
globe -> کره زمین
dam -> سد
verify -> تایید کنید
criticism -> انتقاد
thirst -> تشنگی
limp -> لنگی
unpack -> باز کردن بسته بندی
trim -> کوتاه کردن
sphere -> کره
preparation -> آماده سازی
pear -> گلابی
headline -> عنوان
grape -> انگور
vitamin -> ویتامین
uncertain -> نا معلوم
stern -> سختگیر
sponsor -> حامی
peculiar -> عجیب و غریب
grain -> غلات
painter -> نقاش
notebook -> نوت بوک
vanish -> ناپدید شدن
tackle -> برخورد با
fisherman -> ماهیگیر
decorate -> تزئین کنید
salvation -> رستگاری
nausea -> حالت تهوع
inherit -> به ارث می برند
nosy -> فضول
passive -> منفعل
orchestra -> ارکستر
gourmet -> لذیذ
tickle -> قلقلک دادن
heating -> گرمایش
scatter -> پراکنده کردن
slavery -> برده داری
herd -> گله
heap -> پشته
solar -> خورشیدی
sculpture -> مجسمه سازی
lace -> توری
sensation -> احساس
savage -> وحشی
noodle -> رشته فرنگی
vocabulary -> واژگان
tractor -> تراکتور
gulf -> خلیج
probable -> محتمل
hangover -> خماری
thrust -> رانش
flee -> فرار کن
daring -> شجاعانه
paragraph -> پاراگراف
mist -> غبار
deceive -> فریب دادن
spectacle -> تماشایی
vacant -> خالی
shrine -> زیارتگاه
dedicate -> وقف کن
coupon -> کوپن
zoom -> بزرگنمایی
mercy -> رحمت
lively -> زنده
equivalent -> معادل
compensation -> جبران خسارت
canvas -> بوم
vivid -> واضح
outdoor -> در فضای باز
litter -> آشغال
gallon -> گالن
firmly -> محکم
moustache -> سبیل
marble -> سنگ مرمر
hesitation -> تردید
daytime -> روز
shortage -> کمبود
monthly -> ماهانه
renew -> تجدید
refund -> بازپرداخت
deliberate -> حساب شده
zipper -> زیپ
rainy -> بارانی
overload -> اضافه بار
module -> مدول
merchant -> تاجر
leftover -> پس مانده غذا
textbook -> کتاب درسی
flour -> ارد
ruler -> خط كش
currency -> واحد پول
wrinkle -> چین و چروک
rust -> زنگ
undoubtedly -> بی شک
timetable -> جدول زمانی
publisher -> ناشر
penalty -> پنالتی
quid -> کود
queue -> صف
qualification -> صلاحیت
recognition -> به رسمیت شناختن
recommendation -> توصیه
reference -> مرجع
reflection -> بازتاب
refrigerator -> یخچال
regional -> منطقه ای
register -> ثبت نام
registration -> ثبت
regulation -> مقررات
relatively -> به طور نسبی
relevant -> مربوط
religious -> دینی
rely -> تکیه
remaining -> باقی مانده است
remarkable -> قابل توجه
remote -> از راه دور
replacement -> جایگزینی
reply -> پاسخ
representation -> نمایندگی
republic -> جمهوری
require -> نیاز
requirement -> نیاز
resident -> مقیم
resign -> استعفا دهد
resistance -> مقاومت
resolution -> وضوح
resolve -> برطرف کردن
respectively -> به ترتیب
retain -> حفظ
retirement -> بازنشستگی
revenue -> درآمد
reverse -> معکوس
reward -> جایزه
rhythm -> ریتم
ridiculous -> مسخره - مضحک
rival -> رقیب
rope -> طناب
roughly -> تقریبا
rubber -> لاستیک
rubbish -> زباله
rural -> روستایی
significance -> اهمیت
significant -> قابل توجه
significantly -> به طور قابل ملاحظه
so-called -> باصطلاح
software -> نرم افزار
solicitor -> وکیل دادگستری
sore -> دردناک
southern -> جنوبی
specialist -> متخصص
species -> گونه ها
specify -> مشخص نمودن
spelling -> املا
spill -> ریختن
spiritual -> معنوی
spite -> با وجود
spokesman -> سخنگو
stall -> غرفه
stare -> خیره شدن
steep -> شیب تند
straightforward -> سرراست
strategic -> راهبردی
strengthen -> تقویت
string -> رشته
subsequent -> متعاقب
subsequently -> متعاقبا
suggestion -> پیشنهاد
surprisingly -> به طرز شگفت انگیزی
sustain -> حفظ کنند
sweep -> جارو کردن
technique -> تکنیک
terrorist -> تروریست
theme -> موضوع
theoretical -> نظری
thus -> بدین ترتیب
tile -> کاشی
trailer -> تریلر
transform -> تبدیل
transition -> انتقال
transportation -> حمل و نقل
tray -> سینی
tremendous -> عظیم
troop -> گروه
unemployment -> بیکاری
vague -> مبهم
abnormal -> غیرطبیعی
absent -> غایب
abstract -> چکیده
abundant -> فراوان
accessible -> در دسترس
acute -> حاد
addicted -> معتاد
aesthetic -> زیبایی شناختی
agile -> چابک
ambiguous -> مبهم
ambitious -> جاه طلب
ample -> کافی
anonymous -> ناشناس
artificial -> ساختگی
artistic -> هنری
assertive -> اظهار کننده
astonishing -> عجیب
automatic -> خودکار
balanced -> متعادل
backyard -> حیاط خلوت
baggage -> بار سفر
ballet -> باله
barbarian -> بربر
barber -> سلمانی
barefoot -> پابرهنه
bark -> پارس سگ
bathe -> حمام کردن
beak -> منقار
been -> بوده
beginner -> مبتدی
beginning -> شروع
beige -> رنگ بژ
being -> بودن
beneficial -> سودمند
biased -> جانبدارانه
bikini -> بیکینی
billboard -> تابلو تبلیغاتی
billiards -> بیلیارد
bind -> بستن
biography -> زندگینامه
biology -> زیست شناسی
bishop -> راهب
blackboard -> تخته سیاه
blend -> مخلوط کردن
blossom -> شکوفه - گل
blouse -> بلوز
blown -> دمیده شده
blush -> سرخ شدن
bold -> پررنگ
boundary -> مرز
brag -> لاف زدن
breadth -> وسعت
breakup -> جدایی
breathe -> نفس کشیدن
breed -> نژاد
breeze -> نسیم
bribery -> رشوه دادن
bronze -> برنز
browse -> مرور کردن
bruise -> کبودی
buffet -> بوفه
bumper -> سپر
bundle -> دسته
bureaucracy -> بوروکراسی
burglar -> سارق
burp -> اروغ زدن
cab -> تاکسی
cabbage -> کلم
calculation -> محاسبه
calculator -> ماشین حساب
calf -> گوساله
calligraphy -> خوشنویسی
calorie -> کالری
camel -> شتر
camouflage -> استتار
canal -> کانال
cane -> نیشکر
cannon -> توپ
canyon -> دره
cape -> شنل
caption -> عنوان
carbon -> کربن
cardboard -> مقوا
careless -> بی توجه
cargo -> محموله
carpenter -> نجار
carriage -> کالسکه
carry on -> ادامه دادن
carsick -> ماشین سوار
cartoon -> کارتون
cashier -> صندوقدار
cassette -> نوار کاست
casualty -> سانحه، کشته
cattle -> گاو
caught -> گرفتار
caution -> احتیاط
cautious -> محتاط
cellar -> انبار
celsius -> درجه سانتیگراد
censor -> سانسور
centigrade -> درجه سانتیگراد
chalk -> گچ
characterize -> مشخص کردن
chilly -> سرد
chimney -> دودکش
chore -> کارهای عادی و روزمره
circuit -> جریان
civilian -> غیر نظامی
civilization -> تمدن
civilize -> متمدن کردن
clap -> کف زدن
clarify -> روشن کردن
clash -> برخورد
classical -> کلاسیک
classify -> طبقه بندی کردن
classmate -> همکلاسی
clause -> عبارت
cleaner -> پاک کننده
clockwise -> در جهت عقربه های ساعت
clinical -> بالینی
cloudy -> ابری
clumsy -> دست و پا چلفتی
coalition -> ائتلاف
coastline -> خط ساحلی
cocoa -> کاکائو
coconut -> نارگیل
coercive -> اجباری
cogent -> قانع کننده
coherence -> انسجام
coherent -> منسجم
coincident -> تصادفی
colloquial -> محاوره ای
colonel -> سرهنگ
colonialism -> استعمار
colonist -> استعمارگر
colony -> مستعمره
colourful -> رنگارنگ
columnist -> مقالهنویس
comb -> شانه کردن
comma -> کاما
command -> فرمان
commentary -> تفسیر
commerce -> تجارت
commodity -> کالا
companion -> همراه و همدم
compass -> قطب نما
gemini -> جوزا
kin -> خویشاوندان
scammer -> کلاهبردار
debut -> شروع کردن - آغاز - اولین
decoy -> طعمه ی شکار پرنده
decrease -> نزول کردن
deduct -> کسر کردن
defective -> معیوب
dehydrated -> کم آب شده
delegate -> نماینده
delinquent -> متخلف
dependable -> قابل اعتماد
descend -> فرود آمدن
descendent -> تبار
detest -> نفرت داشتن
diagnose -> تشخیص دادن
diameter -> قطر
disadvantage -> عیب
does -> میکند
educate -> آموزش
eject -> بیرون انداختن
enforce -> اجرا کنند
enlarge -> بزرگنمایی کنید
enquiry -> استعلام
entrepreneur -> کارآفرین
eraser -> پاک کن
erosion -> فرسایش
erupt -> فوران
eruption -> فوران
etc -> و غیره
ethnic -> قومی
evaluate -> ارزیابی کنید
exaggerate -> اغراق کردن، مبالغه
exceed -> تجاوز
excite -> برانگیختن
exclaim -> بانگ زدن
exclude -> حذف کردن
exhibit -> نمایشگاه
exhibition -> نمایشگاه
exile -> تبعید
expansion -> گسترش
expedition -> اعزام
expel -> اخراج کردن
export -> صادرات
external -> خارجی
eyebrow -> ابرو
eyelash -> مژه
faraway -> خیلی دور
fatality -> مرگبار
fatigue -> خستگی
favourable -> مطلوب
fearful -> ترسناک
february -> فوریه
fertile -> بارور
fibber -> فیبر
fiscal -> مالی
fitness -> تناسب اندام
famine -> قحطی
flinch -> چشمک زدن
fluctuate -> نوسان می کند
fluent -> روان، سلیس
font -> فونت
forecast -> پیش بینی
foreigner -> خارجی
format -> قالب
fossil -> فسیلی
fraction -> کسر
fragrance -> عطر
framework -> چارچوب
furnish -> مبله کردن
gadget -> ابزار
gangster -> گانگستر
garment -> لباس
garnish -> چاشنی زدن
gasp -> نفس کشیدن
gave -> داد
gaze -> خیره شدن
gel -> ژل
generalization -> تعمیم
generalize -> تعمیم دادن
generic -> عمومی
geography -> جغرافیا
geometry -> هندسه
giggle -> خندیدن
given -> داده شده
glacier -> یخچال طبیعی
gloomy -> غمگین
glory -> شکوه
graceful -> برازنده
gradual -> تدریجی
graphics -> گرافیک
groan -> ناله
grocer -> بقالی
habitat -> زیستگاه
habitual -> معمولی
handkerchief -> دستمال
hardy -> مقاوم
harmful -> زیان آور
has -> دارد
hassle -> عذاب، عذاب دادن
haste -> عجله
hereditary -> ارثی
hierarchy -> سلسله مراتب
hinder -> مانع شود
horizontal -> افقی
horoscope -> طالع بینی
horseback -> اسب سواری
housewife -> خانم خانه دار
humidity -> رطوبت
humorous -> طنز
hut -> کلبه
hydrogen -> هیدروژن
hypnotize -> هیپنوتیزم کردن
idiom -> اصطلاح
ignorant -> نادان
illiterate -> بی سواد
illogical -> غیر منطقی
illustration -> تصویر
imitate -> تقلید کنید
immigrant -> مهاجر
immigrate -> مهاجرت کنند
immune -> مصون
impartial -> بی طرف
impolite -> بی ادب
income tax -> مالیات بر درآمد
incomplete -> ناقص
indirect -> غیر مستقیم
indoor -> داخلی
informal -> دوستانه و غیر رسمی
inhabitant -> مقیم
inhale -> استنشاق
inland -> داخلی
insert -> درج کنید
inspection -> بازرسی
insure -> بیمه کنند
integration -> ادغام
interested -> علاقه مند
intermediate -> حد واسط
internet -> اینترنت
intersection -> تقاطع
interval -> فاصله
invention -> اختراع
inward -> درون
irritate -> تحریک کردن
isolate -> منزوی
its -> آن
ivory -> عاج
kneel -> زانو زدن
knit -> بافتن
known -> شناخته شده
landscape -> چشم انداز
latitude -> عرض جغرافیایی
latter -> دومی
legislation -> قانون گذاری
lily -> زنبق
lint -> پرز
literary -> ادبی
locally -> به صورت محلی
loitering -> پرسه زدن
longitude -> طول جغرافیایی
lottery -> بخت آزمایی
lumber -> چوب
lying -> دروغ گویی
lyrics -> متن ترانه
machinery -> دستگاه
made-up -> ساخته شده. مصنوعی
magnitude -> اندازه
manufacture -> ساخت
manufacturer -> سازنده
married -> متاهل
mathematics -> ریاضیات
meadow -> چمنزار
means -> به معنای
measurement -> اندازه گیری
melody -> ملودی
metric -> متریک
metropolitan -> شهر بزرگ
midday -> ظهر
midterm -> میان ترم
mineral -> معدنی
minimal -> حداقل
missing -> گم شده
misunderstand -> سوء تفاهم
moderate -> در حد متوسط
modify -> تغییر
moist -> مرطوب
moisture -> مرطوب
mould -> قالب
molecule -> مولکول
monument -> بنای تاریخی
monopoly -> انحصار
mosquito -> پشه
nationality -> ملیت
necessity -> ضرورت
neglect -> بی توجهی
nonfiction -> غیر داستانی
numb -> بی‌حس
numeral -> عددی
nutrition -> تغذیه
obedient -> مطیع
obese -> چاق
obituary -> آگهی فوت
oblige -> وادار کردن
oily -> روغنی
old-fashioned -> سبک قدیمی
olympics -> المپیک
omelette -> املت
omit -> حذف کردن
oneself -> خود
onto -> به سوی
optional -> اختیاری
opt -> انتخاب کردن
orthodox -> ارتدکس
ours -> مال ما
outdoors -> بیرون از خانه
outgoing -> برونگرا
outline -> طرح کلی
outlook -> چشم انداز
outspoken -> صریح
outward -> بیرونی
overdo -> زیاده روی
overdone -> بیش از حد
overestimate -> بیش از حد
overflow -> سرریز
overtake -> سبقت گرفتن
overwhelm -> غرق کردن
overwork -> کار زیاد
ox -> گاو نر
paid -> پرداخت شده
pail -> سطل
pajamas -> لباس خواب
panel -> پانل
parrot -> طوطی
part-time -> پاره وقت
participant -> شرکت کننده
participation -> مشارکت
particle -> ذره
paste -> چسباندن
patent -> ثبت اختراع
pedestrian -> عابر پیاده
peer -> همتا
peninsula -> شبه جزیره
perpendicular -> عمود بر
persist -> اصرار ورزیدن
pessimistic -> بدبین
pianist -> پیانیست
plantation -> مزرعه
plural -> جمع
popularity -> محبوبیت
postage -> هزینه پست
postman -> پستچی
pram -> کالسکه بچه
precede -> مقدم بودن
precedent -> سابقه
pronunciation -> تلفظ
prospect -> چشم انداز
punctual -> وقت شناس
racism -> نژاد پرستی
radiation -> تابش - تشعشع
reasonably -> منطقی
recycle -> بازیافت
redundancy -> افزونگی
refreshment -> طراوت
remedy -> درمان
removal -> حذف
renovate -> بازسازی کند
respectful -> احترام
restless -> بی قرار
resume -> از سرگیری
rigid -> سفت و سخت
rinse -> آبکشی کنید
yield -> بازده
weep -> اشک ریختن
went -> رفت
whale -> نهنگ
widen -> گسترده شود
width -> عرض
windy -> بادی
wink -> چشمک
worship -> عبادت
vacancy -> جای خالی
variable -> متغیر
vat -> مالیات بر ارزش افزوده
vein -> رگ
verb -> فعل
vertical -> عمودی
veteran -> کهنه سرباز
viewpoint -> نظر
vinegar -> سرکه
vocational -> فنی و حرفه ای
vowel -> حرف صدادار
voyage -> سفر دریایی
underline -> زیر خط بکش
uneasy -> ناآرام
unite -> متحد کردن
unity -> وحدت
unlucky -> بد شانس
upright -> عمودی
upward -> بطرف بالا
utility -> سودمندی
tame -> رام کردن
telegraph -> تلگراف
tentative -> آزمایشی
texture -> بافت
thermometer -> دماسنج
thesaurus -> اصطلاحنامه
thread -> نخ
tights -> لباس تنگ
timber -> چوب
tolerate -> تحمل كردن
toward -> به سمت
translation -> ترجمه
transparent -> شفاف
treaty -> معاهده
tremble -> لرزیدن
tropical -> گرمسیری
tulip -> گل لاله
said -> گفت
sank -> غرق شد
satisfactory -> رضایتبخش
saucer -> نعلبکی
sauna -> سونا
saw -> اره
scarlet -> قرمز مایل به قرمز
scholar -> محقق
scissors -> قیچی
scold -> سرزنش کردن
scramble -> تقلا
scrape -> خراش دادن
seafood -> غذای دریایی
seaside -> دریا کنار
selective -> انتخابی
sensual -> حسی
shilling -> شیلینگ
sideways -> به پهلو
simultaneous -> همزمان
singular -> مفرد
skeleton -> اسکلت
skyscraper -> آسمان خراش
slang -> زبان عامیانه
sieve -> غربال کردن
sled -> سورتمه
slender -> باریک
softly -> به نرمی
solemn -> رسمی
sprinkle -> پاشیدن
squirrel -> سنجاب
stationery -> لوازم التحرير
stimulate -> تحریک
comprehend -> درک کردن
comprehensive -> همه جانبه
compute -> محاسبه کنید
consist -> تشکیل شده است از
construct -> ساختن
consultation -> مشاوره
cucumber -> خیار
cuisine -> غذا
subscribe -> اشتراک در
accelerate -> سرعت بخشیدن
advertise -> تبلیغات
wallpaper -> کاغذ دیواری
waterfall -> آبشار
attain -> به دست آوردن
avail -> فایده
boast -> به رخ کشیدن
confectionery -> شیرینی پزی
dazzle -> خیره شدن
debris -> زباله
deteriorate -> بدتر شدن
dexterity -> مهارت
dining-room -> ناهارخوری
disclose -> فاش کردن
disobedience -> نافرمانی
dispel -> از بین بردن
earphones -> گوشی
extinguish -> خاموش کردن
eyeshadow -> سایه چشم
fir -> صنوبر
heaviness -> سنگینی
hemisphere -> نیمکره
herald -> قاصد
hoarse -> خشن
hospitable -> مهمان نواز
hyphen -> خط ربط
hypocrisy -> دورویی
ignition -> آتش گرفتن
incite -> تحریک کردن
inclose -> نزدیک
incorrect -> غلط
instruct -> دستور دادن
integral -> انتگرال
intestine -> روده
invoice -> صورتحساب
jug -> کوزه
junction -> اتصال
lard -> گوشت خوک
lavish -> مجلل
laziness -> تنبلی
lever -> اهرم
libel -> افترا
lyrical -> بزمی، غزلی
malice -> بدخواهی
mammal -> پستاندار
marmalade -> مارمالاد
merge -> ادغام
miser -> خسیس
mistrust -> بی اعتمادی
monarchy -> سلطنت
muse -> در فکر فرو رفتن
mute -> بی صدا
narrative -> روایت
nostril -> سوراخ بینی
notorious -> بدنام
nought -> هیچ
nourish -> تغذیه کند
oblivion -> فراموشی
obscure -> مبهم
ointment -> پماد
omission -> حذف
orchard -> باغ میوه
owing -> مدیون
pamper -> بناز پروردن
parsley -> جعفری
pastime -> سرگرمی
pat -> ضربه زدن
patron -> حامی
pavement -> پیاده رو
peasant -> دهقان
plausible -> محتمل
predatory -> درنده
predominant -> غالب
proficient -> مسلط
proverb -> ضرب المثل
repel -> دفع کردن
reside -> اقامت داشتن
ridicule -> تمسخر
rigorous -> سختگیرانه
robust -> قدرتمند
seaweed -> جلبک دریایی
semicolon -> نقطه ویرگول
situated -> واقع شده است
skier -> اسکی باز
slum -> محله فقیر نشین
smith -> اسمیت
snail -> حلزون
superb -> عالی
surname -> نام خانوادگی
yearly -> سالانه
witch -> جادوگر
charges -> اتهامات
smoke -> دود
according -> با توجه
bob -> باب
lieutenant -> ستوان
breathing -> نفس کشیدن
disappointed -> ناامید شده
rip -> پاره کردن
begging -> التماس کردن
yourselves -> خودتان
baseball -> بیسبال
testify -> گواهی دادن
coma -> کما
mansion -> عمارت
personality -> شخصیت
commander -> فرمانده
buzz -> وزوز
surveillance -> نظارت
woo -> وو
penthouse -> پنت هاوس
sneaking -> یواشکی
constable -> پاسبان
feeding -> تغذیه
courtroom -> دادگاه
reverend -> بزرگوار
enchantment -> افسون
drunken -> مست
bullying -> قلدری
weasel -> راسو
supreme -> عالی
maker -> سازنده
haunted -> خالی از سکنه
footage -> فیلم
bogus -> ساختگی
autograph -> دستخط
spontaneous -> خود جوش
probation -> تحت مراقبت
identical -> همسان
fist -> مشت
cooler -> خنک کننده
banner -> بنر
streak -> خط
spectacular -> دیدنی و جذاب - تماشایی
sector -> بخش
heroin -> هروئین
having -> داشتن
fisher -> ماهیگیر
encouraging -> دلگرم کننده
cult -> فرقه
consult -> مشورت کردن
bailed -> وثیقه
association -> اتحادیه
rag -> کهنه
maniac -> دیوانه
impulse -> تکانه
duchess -> دوشس
classy -> درجه یک
charging -> شارژ کردن
rising -> رو به افزایش
hypocrite -> منافق
humiliate -> تحقیر کردن
hideous -> زشت و زننده
captured -> اسیر
bolt -> پیچ
betting -> شرط بندی
spreading -> در حال گسترش
ransom -> فدیه
jew -> یهودی
intent -> قصد
gladly -> با خوشحالی
fling -> پرت کردن
eliminate -> از بین بردن
disorder -> بی نظمی
chancellor -> صدراعظم
subway -> مترو
republican -> جمهوری خواه
paralyzed -> فلج شده
dental -> دندانی
corporation -> شرکت
cherish -> گرامی داشتن
briefing -> خلاصه سازی
bluff -> بلوف
gin -> جین
gale -> باد
fainted -> غش کرد
dried -> خشک شده
allright -> خیلی خوب
acknowledge -> اذعان
whiskey -> ویسکی
toxic -> سمی
skating -> اسکیت سواری
reliable -> قابل اعتماد
quicker -> سریعتر
overturn -> واژگون شدن
lining -> آستر
harassing -> آزار دهنده
endless -> بی پایان
convict -> محکوم
butler -> خدمتکار
rusty -> زنگ زده
positively -> مثبت
mount -> کوه
manual -> کتابچه راهنمای
helmet -> کلاه ایمنی
failing -> شکست خوردن
essence -> ذات
dose -> دوز
bully -> گردن کلفت
airline -> شرکت هواپیمایی
hooligan -> هولیگان
rig -> دکل
pursuit -> دستیابی
greedy -> طمع کار
spine -> ستون فقرات
shotgun -> تفنگ ساچمه ای
reckless -> بی پروا
rash -> کهیر
railroad -> راه آهن
psychiatric -> روانپزشکی
meaningless -> بی مفهوم
fiancé -> نامزد
exposure -> قرارگیری در معرض
evidently -> از قرار معلوم، مشخصا
contempt -> تحقیر
theft -> سرقت
shipment -> حمل و نقل
scissor -> قیچی
proposition -> قضیه
porter -> باربر
matching -> تطابق
marine -> دریایی
legacy -> میراث
ink -> جوهر
hormone -> هورمون
hail -> تگرگ
godfather -> پدرخوانده
gently -> به آرامی
establish -> تاسيس كردن
worldwide -> در سراسر جهان
sexually -> از نظر جنسی
nicest -> زیباترین
jaw -> فک
intern -> کارآموز
handcuff -> دستبند
franchise -> حق امتیاز
errand -> کارهای محوله
entertaining -> سرگرم کننده
crib -> گهواره
barge -> بارج
attending -> شرکت کردن
ambassador -> سفیر
rating -> رتبه بندی
float -> شناور
embrace -> پذیرفتن
whining -> ناله کردن
turner -> چرخاننده
receiver -> گیرنده
pep -> پپ
olive -> زیتون
jeep -> جیپ
cheerleader -> تشویق کننده
balm -> مومیایی کردن
unnecessary -> غیر ضروری
stunning -> خیره کننده
shipping -> حمل دریایی
quest -> جستجو
luxury -> لوکس
loosen -> شل کردن
info -> اطلاعات
hum -> زمزمه
haunt -> خالی از سکنه
gracious -> بخشنده
forgiving -> بخشنده
emperor -> امپراتور
abortion -> سقط جنین
physician -> پزشک
perimeter -> محیط
passage -> گذر
pal -> رفیق
longest -> طولانی ترین
jews -> یهودیان
interference -> دخالت
grease -> گریس
eyewitness -> شاهد عینی
enthusiasm -> اشتیاق
strongest -> قوی ترین
shaken -> تکان داده شده است
portal -> پورتال
jewel -> جواهر
concrete -> بتن
bearing -> یاتاقان
sabotage -> خرابکاری
pea -> نخود
needy -> نیازمند
mentor -> مرشد
listed -> ذکر شده
cuff -> کاف
yummy -> لذیذ
woof -> بافت
valid -> معتبر
prank -> شوخی
performing -> اجرا کردن
obnoxious -> ناراحت کننده - شدیدا ناخوشایند
hereby -> بدین وسیله
void -> خالی
strangle -> خفه کردن
senate -> سنا
fiction -> داستان
exotic -> خارجی
demonic -> اهریمنی
coloured -> رنگی
clearing -> پاکسازی
brook -> نهر
boutique -> بوتیک
terrace -> تراس
skiing -> اسکی
righty -> درسته
quack -> لات
preliminary -> مقدماتی
petty -> خرده پا
pact -> پیمان
knot -> گره
ketchup -> سس گوجه
assist -> کمک کند
violet -> بنفش
uptight -> بالا بردن
terrifying -> وحشتناک
swamp -> باتلاق
secretly -> مخفیانه
rejection -> طرد شدن
mentally -> ذهنی
jurisdiction -> صلاحیت قضایی
deception -> فریب
crucial -> حیاتی
cheesy -> پنیری
arrival -> ورود
supporting -> حمایت می کند
scoop -> اسکوپ
ribbon -> روبان
raid -> حمله
hay -> یونجه
easter -> عید پاک
destined -> مقدر شده است
constitution -> قانون اساسي
boob -> سینه
appreciation -> قدردانی
accomplice -> همدستان
sewer -> فاضلاب
scroll -> طومار
fugitive -> فراری
cranky -> لعنتی
bodyguard -> محافظ شخصی
accountant -> حسابدار
whoop -> وای
remotely -> از راه دور
protocol -> پروتکل
nickel -> نیکل
foreman -> سرکارگر
decency -> نجابت
cord -> طناب
beam -> پرتو
altogether -> در مجموع
squash -> اسکواش
rank -> رتبه
ought -> باید
lung -> ریه
largest -> بزرگترین
enforcement -> اجرا
encumbrance -> بار
donation -> اهدا
curb -> محدود کردن
continued -> ادامه داد
competitive -> رقابتی
businessman -> تاجر
antique -> عتیقه
advertising -> تبلیغات
ads -> تبلیغات
toothbrush -> مسواک
retreat -> عقب نشینی
panties -> شورت
lust -> شهوت
hourglass -> ساعت شنی
equally -> به همان اندازه
consolation -> تسلی
babble -> غرغر کردن
stranded -> سرگردان
payslips -> فیش حقوقی
overreact -> بیش از حد واکنش نشان دهند
freshen -> تازه کردن
drake -> دریک
disposal -> دسترس
caffeine -> کافئین
broom -> جارو
unfinished -> ناتمام
tasty -> خوش طعم
syndrome -> سندرم
stack -> پشته
pinch -> نیشگون گرفتن
isolated -> جدا شده
flatten -> صاف کردن
whereabouts -> محل تقریبی
waiting -> در انتظار
truce -> آتش بس
tee -> سه راهی
ruling -> حکم می کند
poise -> متانت
manipulative -> دستکاری
immature -> نابالغ
delivering -> تحویل دادن
condom -> کاندوم
butt -> لب به لب
automatically -> بطور خودکار
anchor -> لنگر
addict -> معتاد
throne -> تخت پادشاهی
slick -> نرم
raining -> باران
pasta -> پاستا
detector -> آشکارساز
coolest -> جالبترین
casting -> ریخته گری
batch -> دسته ای
almighty -> خداوند متعال
sum -> مجموع
spark -> جرقه
perfection -> کمال
jelly -> ژله
getaway -> فرار
cracking -> ترک خوردن
behold -> ببین
verge -> لبه
timer -> تایمر
surf -> موج سواری
superman -> سوپرمن
specialty -> تخصص
snoop -> اسنوپ
semi -> نیمه
leverage -> قدرت نفوذ
jeopardize -> به خطر اندازد
janitor -> سرایدار
examination -> معاینه
compact -> فشرده - جمع و جور
clueless -> بی خبر
arriving -> رسیدن
adding -> اضافه كردن
ungrateful -> ناسپاس
unacceptable -> غیر قابل قبول
shorter -> کوتاه تر
serum -> سرم
lure -> طعمه
irrational -> غیر منطقی
galaxy -> کهکشان
doom -> عذاب
classified -> طبقه بندی شده
beautifully -> به زیبایی
approaching -> نزدیک شدن
traitor -> خائن
sympathetic -> دلسوز
smug -> از خود راضی
rental -> اجاره ای
prostitute -> فاحشه
monk -> راهب
inventory -> فهرست
improved -> بهبود یافته
horny -> شاخدار
developing -> در حال توسعه
commonplace -> عادی
banging -> کوبیدن
amendment -> اصلاحیه
vent -> تهویه
traumatic -> پس از سانحه
tow -> دویدن
sweaty -> عرق کرده
overboard -> روی دریا
insight -> بینش، بصیرت، درون بینی
haven -> پناهگاه
fluid -> مایع
era -> عصر
crappy -> کم ارزش
crab -> خرچنگ
chunk -> تکه
chandler -> چندلر
appliance -> دستگاه
stain -> لکه دار کردن
shack -> کلبه
pervert -> منحرف
occupied -> مشغول
handful -> تعداد انگشت شماری
gag -> دهان بستن
flick -> تلنگر
expertise -> تجربه و تخصص
embarrassment -> خجالت
drum -> طبل
concussion -> ضربه مغزی
summon -> احضار
splitting -> تقسیم کردن
sneaky -> موذی
sloppy -> درهم و برهم
settling -> حل و فصل
reschedule -> زمانبندی دوباره
notch -> بریدگی
hooray -> هورا
extend -> توسعه دادن، گسترش
exquisite -> نفیس
disrespect -> بی احترامی
amateur -> آماتور
voting -> رای دادن
shatter -> خرد کردن
ruthless -> بی رحم
refill -> دوباره پر کردن
payroll -> حقوق و دستمزد
mourning -> عزاداری
marijuana -> ماری جوانا
manly -> مردانه
iris -> عنبیه
involving -> که شامل
hunk -> تکه تکه
entertain -> سرگرم کردن
earthquake -> زمين لرزه
drift -> رانش
dreadful -> وحشتناک
doorstep -> آستانه در
confirmation -> تائیدیه
stressful -> پر استرس
preoccupy -> مشغول کردن
predictable -> قابل پیش بینی
madly -> دیوانه وار
embassy -> سفارت
confuse -> گیج کردن
cappuccino -> کاپوچینو
bouquet -> دسته گل
bailey -> بیلی
amulet -> طلسم
addiction -> اعتیاد
warming -> گرم شدن
villa -> ویلا
unlock -> باز کردن قفل
satisfy -> راضی کردن
relaxing -> آرامش بخش
lone -> تنها
fudge -> سخن بی معنی وبیهوده
elaborate -> دارای جزئیات - بسیط
concerning -> مربوط به
blocking -> مسدود کردن
mode -> حالت
hunger -> گرسنگی
hamburger -> همبرگر
greet -> سلام کردن
gravy -> سس
dreamt -> خواب دید
dice -> تاس
collecting -> جمع آوری
backpack -> کوله پشتی
agreeing -> موافق
supervisor -> سرپرست
starling -> سار
meter -> متر
likewise -> به همین ترتیب
irrelevant -> غیر مرتبط
felon -> جنایتکار
fasten -> بستن
easiest -> آسان ترین
disco -> دیسکو
conceivable -> ممکن
compassionate -> دلسوز
backstage -> پشت صحنه
agony -> عذاب
adorn -> آراستن
tweak -> نیشگون گرفتن و کشیدن
thieve -> دزد
surgical -> جراحی
sunrise -> طلوع خورشید
strangely -> به طرز عجیبی
recital -> رسیتال
productive -> سازنده
meaningful -> معنی دار
marching -> راهپیمایی
kitten -> بچه گربه
immunity -> مصونیت
frighten -> ترساندن
dearly -> عزیزم
closure -> بسته
ambition -> هدف - آرزو
unstable -> ناپایدار
sweetness -> شیرینی
stinky -> بدبو
salvage -> نجات
petition -> دادخواست
lowlife -> زندگی پست
juicy -> آبدار
intentionally -> عمدا
inspire -> الهام بخشیدن
forgave -> بخشید
fart -> گوز
devotion -> تعلق خاطر
despicable -> نفرت انگیز
comfy -> راحت
breach -> رخنه
alternate -> متناوب
twilight -> گرگ و میش
stove -> اجاق گاز
slot -> اسلات
pawn -> پیاده
lengthen -> طولانی کردن
farewell -> بدرود
experimental -> تجربی
caviar -> خاویار
carnival -> کارناوال
boost -> تقویت
bliss -> سعادت
token -> نشانه
temporarily -> به طور موقت
superstition -> خرافات
supernatural -> فراطبیعی
sunk -> غرق شد
recorder -> ضبط کننده
rang -> زنگ زد
presidential -> ریاست جمهوری
motivate -> ایجاد انگیزه
fraternity -> برادری
dryer -> خشک کن
chewing -> جویدن
brake -> ترمز
bounty -> فضل
axe -> تبر
unbelievably -> باور نکردنی
survivor -> بازمانده
respectable -> قابل احترام
premise -> فرضیه
occasional -> گاه به گاه
indication -> نشانه
gutter -> ناودان
flashlight -> چراغ قوه
bloodless -> بی خون
beware -> برحذر بودن
wily -> حیله گر
won -> برنده شد
turf -> چمن
shovel -> بیل
puff -> پف کردن
privately -> به صورت خصوصی
locking -> قفل کردن
heartless -> بی دل
echo -> اکو
comparison -> مقایسه
childish -> کودکانه
cardiac -> قلبی
brace -> بند شلوار
blunt -> صریح
admission -> پذیرش
vanilla -> وانیل
utterly -> کاملا
suspension -> تعلیق
stun -> بیهوش کردن
sadly -> با ناراحتی
reserved -> رزرو شده است
lowest -> پایین ترین
kidding -> شوخی کردن
jerk -> تند و سریع
hitch -> تکان دادن
flirt -> معاشقه
extension -> افزونه
establishment -> استقرار
delayed -> با تاخیر
christening -> تعمید
casket -> تابوت
broker -> دلال
antibiotic -> آنتی بیوتیک
abduct -> ربودن
witchcraft -> جادوگری
smelly -> بدبو
running -> در حال اجرا
protein -> پروتئین
paramedic -> امدادگر
newest -> جدیدترین
murmur -> زمزمه کردن
marathon -> ماراتن
intact -> سالم
grandpa -> پدربزرگ
diaper -> پوشک
deceased -> مرحوم
burka -> بورکا
bun -> نان
accounting -> حسابداری
shred -> خرد کردن
rethink -> تجدید نظر کنید
pistol -> تپانچه
leash -> افسار
hearted -> دلسوز
flown -> پرواز کرده
feast -> جشن
extent -> وسعت
educated -> تحصیل کرده
disgrace -> رسوایی
deposition -> گواهی
burial -> خاکسپاری
bookstore -> کتابفروشی
veil -> حجاب
trespass -> تجاوز
optimistic -> خوش بینانه
jeopardy -> خطر
injection -> تزریق
hilarious -> خنده دار
distinct -> متمایز
directed -> جهت دار
dame -> خانم
curve -> منحنی
cone -> مخروط
challenging -> چالش برانگیز
alter -> تغییر دهید
wilderness -> بیابان
vindictive -> کینه جویانه
venture -> ریسک
tomb -> مقبره
teeny -> نوجوان
stroll -> قدم زدن
sitting -> نشستن
rebuild -> بازسازی کنید
ordeal -> مصیبت
intimacy -> صمیمیت
inheritance -> وراثت
exploded -> منفجر شد
donate -> اهدا کنند
distracting -> منحرف کننده
despair -> ناامیدی
democratic -> دموکراتیک
cracker -> ترقه
ammunition -> مهمات
thoroughly -> به طور کامل
sheer -> خالص، ناب
scarecrow -> مترسک
refreshing -> طراوت بخش
prosecute -> تحت تعقیب قرار دادن
misplace -> نابجا
merchandise -> کالا
membership -> عضویت
jinx -> جینکس
heroic -> قهرمانانه
facial -> صورت
clan -> قبیله
bummer -> آزاردهنده
syrup -> شربت
shuttle -> شاتل
resemblance -> شباهت
premature -> زودرس
pod -> غلاف
honours -> افتخارات
gravity -> جاذبه زمین
contribution -> مشارکت
acquainted -> آشنا شد
vest -> جلیقه
untie -> باز کردن
salute -> سلام
priceless -> بسیار گرانبها
pike -> پیک
partying -> مهمانی
moonlight -> مهتاب
lightly -> به آرامی
lifting -> بلند کردن
glowing -> درخشان
generator -> ژنراتور
flowing -> جاری
explosive -> مواد منفجره
cinnamon -> دارچین
breakthrough -> پیشرفت
ballistic -> بالستیک
assassin -> قاتل
antidote -> پادزهر
analyze -> تجزیه و تحلیل
allowance -> کمک هزینه
adjourn -> به تعویق انداختن
understatement -> کم بیان کردن
touchy -> دل نازک
subconscious -> ناخودآگاه
roommate -> هم اتاقی
pitcher -> پارچ
ping -> پینگ
offend -> توهین کردن
knives -> چاقوها
irresistible -> مقاومت ناپذیر
incarnate -> مجسم کردن
hostility -> خصومت
funky -> بد بو
equation -> معادله
digital -> دیجیتال
centered -> متمرکز شده است
watcher -> ناظر
turtle -> لاک پشت
transmission -> انتقال
sleigh -> سورتمه
sarcastic -> طعنه آمیز
recess -> فرورفتگی
rebound -> برگشت
rebel -> شورشی
pirate -> دزد دریایی
living -> زندگي كردن
heartache -> درد دل
fundraiser -> جمع آوری کمک مالی
dynamite -> دینامیت
doorman -> دربان
documentary -> مستند
discreet -> با احتیاط
considerate -> با ملاحظه
catering -> پذیرایی
author -> نویسنده
vacuum -> خلاء
urine -> ادرار
strung -> رشته دار
stitch -> کوک
sordid -> دون؛ پست
protector -> محافظ
portion -> بخش
moss -> خزه
mat -> تشک
kindergarten -> مهد کودک
flaw -> نقص
diving -> شیرجه زدن
discharge -> تخلیه
confidentiality -> محرمانه بودن
blizzard -> کولاک
amongst -> در میان
woody -> چوبی
tactic -> تاکتیک
straits -> تنگه ها
spooky -> شبح وار
spaghetti -> ماکارونی
powerless -> ناتوان
playground -> زمین بازی
paranoia -> پارانویا
hopeful -> امیدوار کننده
havoc -> ویرانی
evaluation -> ارزیابی
eavesdropping -> استراق سمع
doughnut -> دونات
diversion -> انحراف
behead -> سر بریدن
aspen -> آسپن
anyplace -> هر جا
accessory -> لوازم جانبی
titanic -> تایتانیک
stuffing -> پر کردن
speeding -> سرعت زیاد
slime -> لجن
royalty -> حق امتیاز
maze -> مارپیچ
marital -> ازدواج
magician -> شعبده باز
lurk -> کمین کن
journalism -> روزنامه نگاری
interior -> داخلی
hog -> گراز
hatch -> دریچه
greeting -> سلام و احوال پرسی
ethical -> اخلاقی
equipped -> مجهز بودن
environmental -> محیطی
credibility -> اعتبار
credential -> اعتبار
consistent -> استوار
claw -> پنجه
chopped -> خرد شده
bridal -> عروس
bedside -> کنار تخت
babysitting -> نگهداری از کودک
authorized -> مجاز است
assumption -> فرض
youngest -> جوان ترین
witty -> شوخ
unforgivable -> نابخشودنی
underworld -> عالم اموات
sophomore -> سال دوم
selfless -> از خود گذشته
secrecy -> رازداری
runway -> باند
programming -> برنامه نويسي
professionally -> به صورت حرفه ای
moving -> در حال حرکت
meltdown -> ذوب شدن
incoming -> ورودی
funding -> منابع مالی
curl -> حلقه
comedian -> کمدین
buckle -> دست و پنجه نرم کردن
assembly -> مونتاژ
admired -> تحسین شده
adjustment -> تنظیم
slippery -> لغزنده
ridge -> خط الراس
queer -> عجیب و غریب
graveyard -> قبرستان
gifted -> با استعداد
dale -> دیل
cynical -> بدبینانه
assassination -> ترور
verbal -> کلامی
unpredictable -> غیر قابل پیش بینی
stoop -> خم شدن
plumbing -> لوله کشی
lingerie -> لباس زیر زنانه
layer -> لایه
fluffy -> کرکی
dresser -> کمد
coup -> کودتا
chauffeur -> کمک راننده
bouncing -> جهنده
veal -> گوشت گوساله
sanity -> سلامت عقل
primitive -> اولیه
pending -> انتظار
orderly -> منظم
obsessive -> وسواسی
motto -> شعار
meteor -> شهاب سنگ
glimpse -> نظر اجمالی
froze -> منجمد شد
execute -> اجرا کردن
ensure -> اطمینان حاصل شود
dispute -> اختلاف نظر
crop -> محصول
consulate -> کنسولگری
amend -> اصلاح
syringe -> سرنگ
symphony -> سمفونی
sleazy -> سست
shaky -> لرزان
runner -> دونده
riddle -> معما
ranger -> تکاور
poke -> بهم زدن
pickup -> سوار کردن
nutty -> آجیل
menace -> تهدید
inspiring -> الهام بخش
housekeeper -> خانه دار
fingernail -> ناخن دست
chronic -> مزمن
bass -> صدای بم
baking -> پخت
whine -> ناله کردن
utter -> مطلقا
thug -> اراذل و اوباش
strap -> بند
sniff -> بو کشیدن
sedative -> آرام بخش
picket -> قیچی
jumbo -> جامبو
hound -> سگ شکاری
homosexual -> همجنسگرا
flea -> کک
flatter -> چاپلوس کردن
dwell -> ساکن
dent -> فرورفتگی
assignment -> وظیفه
advisor -> مشاور
vile -> پست
unreasonable -> غیر منطقی
souvenir -> سوغات
psychopath -> بیمار روانی
operative -> عامل
obstruction -> انسداد
lockdown -> تعطیلی
gloat -> خوشحالی
filth -> کثیفی
exterminate -> نابود کردن
electronic -> الکترونیکی
edgy -> عصبی
cedar -> سرو
betraying -> خیانت کردن
appealing -> جذاب
wrath -> خشم
trainer -> مربی
rye -> چاودار
publicly -> به صورت عمومی
marshal -> مارشال
heavenly -> بهشتی
hash -> هش
halt -> مکث
grim -> تلخ
employed -> به کار گرفته شده
doggie -> سگ سگ
diplomatic -> دیپلماتیک
dilemma -> دوراهی
contagious -> مسری
cheering -> تشویق کردن
carved -> حکاکی شده
wrench -> آچار
thingy -> شیک
rogue -> سرکش
raft -> قایق
piggy -> خوک
peep -> چشمک زدن
pageant -> مسابقه
liveliness -> سرزندگی
gardener -> باغبان
continuing -> ادامه دارد
vase -> گلدان
squat -> چمباتمه زدن
motivation -> انگیزه
introduction -> مقدمه
feminine -> زنانه
eyeball -> مردمک چشم
disc -> دیسک
convertible -> قابل تبدیل
context -> متن نوشته
suspense -> تعلیق
poppy -> خشخاش
mice -> موش
incompetent -> بی عرضه
drip -> چکه کردن
differ -> فرق داشتن
copper -> فلز مس
sensitivity -> حساسیت
prophecy -> رسالت
immortal -> جاویدان
colourless -> بی رنگ
asking -> درخواست
demonstrate -> نشان دادن
acquaintance -> آشنایی
superficial -> سطحی
ingredient -> جزء
bruised -> کبود شده
apparent -> آشکار
worthwhile -> با ارزش
mop -> پاک کن
impatient -> بی صبر
arctic -> قطب شمال
profound -> عمیق
mocking -> مسخره
concentration -> تمرکز
tribute -> احترام
postcard -> کارت پستال
judgement -> داوری
engineering -> مهندسی
commonwealth -> مشترک المنافع
intimidate -> ترساندن
doorbell -> زنگ درب
cultural -> فرهنگی
café -> کافه
allergy -> آلرژی
vegetarian -> گیاه خواری
telegram -> تلگرام
pharmacy -> داروخانه
obstacle -> مانع
contribute -> مشارکت
bankrupt -> ورشکسته
neurotic -> عصبی
microphone -> میکروفون
persuasive -> متقاعد کننده
lighthouse -> فانوس دریایی
liability -> مسئولیت
detailed -> دقیق
condolences -> تسلیت
bulb -> لامپ
await -> در انتظار
ambush -> کمین کردن
adolescent -> نوجوان
abort -> سقط
verse -> آیه
undermine -> تضعیف کردن
sunlight -> نور خورشید
slippers -> دمپایی
nonetheless -> با این وجود
liaison -> رابط
encouragement -> تشویق
dictate -> دیکته کردن
blueberry -> زغال اخته
apron -> پیشبند
anticipated -> پیش بینی شده است
vouch -> تضمین
sibling -> خواهر و برادر
magically -> به طور جادویی
listener -> شنونده
fearless -> بی باک
dinosaur -> دایناسور
repeatedly -> به طور مکرر
moody -> بد خلق
indulge -> افراط کردن
horribly -> به طرز وحشتناکی
expand -> بسط دادن
dialogue -> گفتگو
adventurous -> پرماجرا
violin -> ویولن
suffice -> کافی است
oatmeal -> بلغور جو دوسر
midst -> وسط
maiden -> دوشیزه
damaging -> آسیب رسان
boredom -> بی حوصلگی
sunglasses -> عینک آفتابی
prognosis -> پیش بینی
molecular -> مولکولی
hazel -> فندق
striking -> قابل توجه، برجسته، موثر
ripe -> رسیده
plumber -> لوله کش
newborn -> نوزاد تازه متولد شده
swift -> سریع
speculation -> حدس و گمان
rewrite -> بازنویسی
handicapped -> معلول
dishonest -> متقلب
amusement -> تفریحی
unborn -> متولد نشده
toaster -> توستر
sew -> دوختن
radioactive -> رادیواکتیو
questionable -> سوال برانگیز
overlook -> نادیده گرفتن
underpants -> زیر شلواری
stool -> مدفوع
platinum -> پلاتین
nightclub -> کلوپ شبانه
minority -> اقلیت
divided -> تقسیم شده
dangerously -> خطرناک
considerable -> قابل توجه
tuition -> شهریه
godmother -> مادرخوانده
crude -> خام
criticize -> انتقاد کنید
whichever -> هر کدام
correction -> تصحیح
incentive -> مشوق
yogurt -> ماست
submarine -> زیردریایی
startle -> وحشت زده شدن
interpretation -> تفسیر
ingoing -> در حال انجام
enchant -> مسحور کردن
conservative -> محافظه کار
bandage -> بانداژ
awareness -> اطلاع
supervision -> نظارت
sedate -> آرام بخش
marker -> نشانگر
brainwash -> شستشوی مغزی
adamant -> تزلزل ناپذیر
uncommon -> غیر معمول
medieval -> قرون وسطایی
maturity -> بلوغ
maternity -> زایمان
marinade -> ماریناد
candid -> صریح
snore -> خروپف کردن
sneeze -> عطسه
smuggle -> قاچاق
salty -> شور
morbid -> بیمارگونه
licence -> مجوز
defenceless -> بی دفاع
cradle -> گهواره
booking -> رزرو
traumatize -> آسیب وارد کردن
muddy -> گل آلود
grapefruit -> گریپ فروت
bossy -> رئیس
bacteria -> باکتری ها
speechless -> بی حرف
parachute -> چتر نجات
cremate -> سوزاندن
transaction -> معامله
polar -> قطبی
intrude -> سرزده
ignorance -> جهل
handyman -> خوش دست
greens -> سبزی ها
diabete -> دیابت
constitutional -> مشروطه
pronoun -> ضمیر
pottery -> کوزه گری
obscene -> ناپسند
induce -> وادار کردن
immigration -> مهاجرت
elevate -> بالا بردن
disable -> غیر فعال کردن
crust -> پوسته
conductor -> رهبر ارکستر
assessment -> ارزیابی
withdrawal -> برداشت از حساب
undone -> انجام نشده
symptom -> علامت
mascara -> ریمل
iceberg -> کوه یخ
convert -> تبدیل
complicate -> پیچیده کردن
combine -> ترکیب کردن
transformation -> دگرگونی
telescope -> تلسکوپ
stumble -> تلو تلو خوردن
saliva -> بزاق
robber -> سارق
reconnect -> دوباره وصل شوید
irregular -> بی رویه
invalid -> بی اعتبار
evict -> اخراج کردن
diver -> غواص
cushion -> کوسن
rhyme -> قافیه
phenomenon -> پدیده
motherhood -> مادر شدن
migraine -> میگرن
frosty -> یخ زده
friction -> اصطکاک
aspect -> جنبه
aggression -> پرخاشگری
abusive -> بد لحن
trivial -> ناچیز
tenant -> مستاجر
supervise -> نظارت
superstitious -> خرافاتی
statistics -> آمار
homemade -> خانگی
glamour -> زرق و برق
disoriented -> سرگردان
crossroad -> چهارراه
assurance -> اطمینان
thesis -> پایان نامه
terrorism -> تروریسم
respectfully -> با احترام
painkiller -> مسکن
intellect -> عقل
dole -> دول
amuse -> سرگرم کردن
alienate -> بیگانه کردن
unwanted -> ناخواسته
soften -> نرم کردن
plaster -> گچ
insomnia -> بیخوابی
fume -> دود
foremost -> در درجه نخست
deviate -> منحرف شدن
crave -> هوس کردن
craft -> مهارت
conceal -> پنهان کردن، پوشاندن
abdomen -> شکم
toenail -> ناخن پا
organism -> ارگانیسم
incapable -> ناتوان
fade -> محو شدن
erotic -> وابسته به عشق شهوانی
dwelling -> سکونت
calory -> کالری
breathtaking -> نفس گیر
unattractive -> غیر جذاب
representative -> نماینده
residential -> مسکونی
resignation -> استعفا
substantial -> قابل توجه
agricultural -> کشاورزی
arbitrary -> دلخواه
damp -> مرطوب
detached -> جدا
dictator -> دیکتاتور
digestion -> گوارش
discourage -> دلسرد کردن
discrimination -> تبعیض
disgraceful -> شرم آور
disguise -> مبدل کردن
disorganized -> بی نظم
diversity -> تنوع
download -> دانلود
compensate -> جبران کردن
competence -> صلاحیت
earnest -> جدی
eclipse -> کسوف
economical -> مقرون به صرفه
elastic -> کشسان
electronics -> الکترونیک
embargo -> تحریم
encyclopaedia -> دایره المعارف
energetic -> پر انرژی
enjoyment -> لذت بردن
enlargement -> بزرگ شدن
envious -> حسود
equator -> استوا
erect -> ایستاده
expenditure -> مخارج
eyelid -> پلک
farsighted -> دور اندیش
feminist -> فمینیست
forfeit -> از دست دادن
fort -> دژ
furthermore -> علاوه بر این
futile -> بیهوده
hazardous -> خطرناک
immortality -> جاودانگی
initially -> در ابتدا
intricate -> پیچیده
juvenile -> نوجوان
kaleidoscope -> کالیدوسکوپ
magnify -> بزرگ کردن
miscellaneous -> متفرقه
momentary -> انی
mutter -> غرغر کردن
nylon -> نایلون
oar -> پارو
orient -> جهت گیری
ornament -> زینت
oxen -> گاو نر
oyster -> صدف خوراکی
parasol -> چتر آفتابی
pasture -> مرتع
pioneer -> پیشگام
playful -> بازیگوش
poisonous -> سمی
practitioner -> متخصص
precision -> دقت، درستی
prefix -> پیشوند
prestige -> اعتبار
punctuation -> نقطه گذاری
quarrel -> نزاع
raffle -> قرعه کشی
rationalize -> منطقی کردن
relay -> رله
rim -> لبه
rugby -> راگبی
scallop -> گوش ماهی
spank -> زدن
specialize -> تخصص
stereotype -> کلیشه
complement -> متمم
completely -> به صورت کامل
completion -> تکمیل
complimentary -> تعارفی
component -> جزء
composition -> ترکیب بندی
comprehension -> درک مطلب
conceited -> متکبر
connoisseur -> خبره
consequently -> در نتیجه
conservation -> حفاظت
considerably -> بطور قابل توجهی
consistency -> ثبات
consonant -> همخوان
conspicuous -> قابل توجه
constitute -> تشکیل می دهند
consumer -> مصرف كننده
consumption -> مصرف
contemplate -> اندیشیدن
contemporary -> امروزی
contented -> راضی
continuous -> مداوم
contradict -> تناقض دارند
contradiction -> تناقض
contrast -> تضاد
controversial -> بحث برانگیز
controversy -> جنجال - جدال سرسختانه
conventional -> مرسوم
copier -> دستگاه کپی
cosmopolitan -> شهری
counterfeit -> تقلبی
countryside -> حومه شهر
cram -> توده
crayon -> مداد رنگی
cricket -> کریکت
cube -> مکعب
cue -> نشانه
culprit -> مقصر
cupboard -> کابینت
curriculum -> برنامه تحصیلی
customs -> گمرک
cylinder -> سیلندر
interim -> موقت
locum -> جایگاه
stride -> گام های بلند برداشتن
subjective -> ذهنی
submission -> ارسال
subordinate -> تابع
subscription -> اشتراک، ابونمان
subtract -> تفریق کردن
suburb -> حومه شهر
supplement -> مکمل
supporter -> حامی
swimsuit -> لباس شنا
syllable -> هجا
syllabus -> سرفصل دروس
abbreviate -> مخفف کردن
abode -> اقامت
abolish -> لغو کند
abound -> فراوان است
abrupt -> ناگهانی
abstinence -> پرهیز
accommodate -> تطبیق
accord -> توافق
accumulate -> انباشتن
accustom -> عادت کردن
acquaint -> آشنا کردن
adhere -> پایبند
adjective -> صفت
administer -> اداره کند
admissible -> قابل قبول
adverb -> قید
adversary -> حریف
affability -> مهربانی
affirm -> تایید کردن
agrarian -> کشاورزی
walnut -> گردو
wary -> محتاط
watery -> آبکی
wharf -> اسکله
whirl -> چرخیدن
wholly -> کاملا
wilful -> با اراده
willingness -> تمایل
wireless -> بی سیم
withhold -> خودداری کنید
wrangle -> دعوا کردن
wring -> فشار دادن
vaccination -> واکسیناسیون
vandalism -> وندالیسم
vapour -> بخار
varnish -> لاک زدن
velocity -> سرعت
venison -> گوشت گوزن
venomous -> زهرآگین
verification -> تایید
versatile -> همه کاره
vestige -> بقایای
vibrate -> ارتعاش
vigilance -> هوشیاری
vigorous -> قوی
visibility -> دید
vogue -> مد
volleyball -> والیبال
vulgar -> مبتذل
vulture -> کرکس
ulcer -> زخم
unaccustomed -> غیرعادی
unavoidable -> اجتناب ناپذیر
unaware -> غافل
unbutton -> باز کردن دکمه
unchanged -> بدون تغییر
undeniable -> غیر قابل انکار
unequal -> نابرابر
uneven -> ناهموار. ناجور
unfamiliar -> نا آشنا
unfriendly -> غیر دوستانه
unjust -> ناعادلانه
unkind -> نامهربان
unruly -> یاغی، سرکش
unrest -> نا آرام
unsettled -> بی قرار
unskilful -> ناشیانه
untidy -> نامرتب
unworthy -> نالایق
upbrining -> تربیت
uphill -> سربالایی
uprising -> قیام
usage -> استفاده
utmost -> بیشترین
tack -> چسب
tangible -> محسوس
tariff -> تعرفه
tea-pot -> قابلمه چای
teaspoon -> قاشق چایخوری
tedious -> خسته کننده
teem -> پر کردن
temporal -> زمانی
tendon -> تاندون
testament -> وصیت نامه
test-tube -> لوله آزمایش
textile -> منسوجات
text-message -> پیام متنی
theological -> الهیاتی
thought -> فکر
threshold -> آستانه
thrift -> صرفه جویی
timid -> ترسو
tint -> رنگ
toil -> زحمت کشیدن
tonsil -> لوزه
torrent -> تورنت
tortoise -> لاک پشت
trait -> صفت
tram -> تراموا
transient -> گذرا
treason -> خیانت
tread -> آج
trickle -> سرماخوردگی
trinity -> تثلیث
trolley -> چرخ دستی
tsar -> تزار
turban -> دستار
turbulent -> آشفته
turnip -> شلغم
tusk -> عاج
twirl -> چرخش
twitter -> توییتر
tyran -> ظالم
typist -> تایپیست
allege -> ادعا کردن
allot -> اختصاص دادن
alloy -> آلیاژ
allude -> اشاره کن
allusion -> کنایه
aloud -> با صدای بلند
alphabet -> الفبا
altitude -> ارتفاع
aluminium -> آلومینیوم
amass -> جمع کردن
amid -> در میان
amnesty -> عفو
amorous -> عاشقانه
anaemia -> کم خونی
analogy -> مقایسه
anatomy -> آناتومی
anew -> دوباره
animate -> جان دادن
animosity -> خصومت
annex -> ضمیمه
anomalous -> غیر عادی
anthem -> سرود
ant-hill -> لانه مورچه
antipathy -> انزجار
antiquarian -> باستانی
apathetic -> بی تفاوت
apostle -> رسول
apparatus -> دستگاه
appease -> تسکین دادن
appendix -> ضمیمه
appoint -> تعیین کنید
appraise -> ارزیابی
apprehension -> دلهره
apprentice -> شاگرد کارآموز
arab -> عربی
arc -> قوس
archbishop -> اسقف اعظم
archives -> آرشیوها
ardent -> پرشور
aristocracy -> اشرافیت
armchair -> صندلی راحتی
armistice -> آتش بس
armpit -> زیر بغل
aroma -> عطر
arouse -> برانگیختن
arrears -> معوقه
artful -> هنرمندانه
ascend -> صعود کردن
ascertain -> مشخص کردن
ashore -> در ساحل
asparagus -> مارچوبه
aspiration -> تنفس
assent -> موافقت
assert -> ادعا کردن
assimilate -> جذب، همانند ساختن
astray -> بیراهه
atheism -> بی خدایی
atrocious -> بی رحمانه
audible -> قابل شنیدن
austerity -> ریاضت
auxiliary -> کمکی
avalanche -> بهمن
aversion -> بیزاری
aviation -> هواپیمایی
bale -> عدل
bamboo -> بامبو
barley -> جو
barracks -> پادگان
barren -> عقیم
barricade -> سد
barter -> معامله پایاپای
beech -> راش
beetroot -> چغندر
benediction -> دعای خیر
bereave -> داغدار شدن
berch -> تخت
bilateral -> دو طرفه
birch -> توس
bladder -> مثانه
bleat -> نفخ کردن
blister -> تاول زدن
blot -> لکه
boar -> گراز
bonfire -> آتش سوزی
bonnet -> کاپوت
botany -> گیاه شناسی
box-office -> باجه بلیط فروشی
boycott -> تحریم کردن
boyish -> پسرانه
brim -> لبه
brisk -> سریع
brooch -> گل سینه
brood -> نوزاد
brow -> ابرو
bulk -> فله
bulletin -> بولتن
buoyancy -> شناوری
calamity -> فاجعه
camomile -> بابونه
canary -> قناری
candied -> آب نبات
canteen -> سالن غذاخوری
canvass -> بوم نقاشی
capability -> قابلیت
caprice -> هوسبازی
captivity -> اسارت
caravan -> کاروان
cardinal -> اصلی
caress -> نوازش
carp -> کپور
cartrige -> کارتریج
cask -> چلیک
cataract -> آب مروارید
caterpillar -> کرم ابریشم
cathedral -> کلیسای جامع
cauliflower -> گل کلم
catastrophe -> فاجعه
cavalry -> سواره نظام
cede -> واگذار کردن
celery -> کرفس
census -> سرشماری
cessation -> توقف
chaste -> پاکدامن
chatter -> پچ پچ کردن
chirp -> چهچهچه
chisel -> اسکنه
chivalrous -> جوانمردانه
chord -> وتر
cipher -> رمزگذاری
clad -> پوشیده شده
clang -> زنگ زدن
clasp -> گیره
clatter -> تق تق
clench -> فشردن
clod -> کلوخ
clove -> میخک
clumsiness -> دست و پا چلفتی
clutch -> کلاچ
coarse -> درشت
coax -> متقاعد کننده
cobbler -> پینه دوز
cod -> کد
cod-liver -> جگر ماهی
cognition -> شناخت
coil -> سیم پیچ
collaborate -> همکاری
colt -> کلت
combustible -> قابل احتراق
comet -> دنباله دار
commence -> آغاز شود
commotion -> هیاهو
compel -> مجبور کردن
compile -> گردآوری
compliance -> انطباق
compose -> ساختن
compress -> فشرده کردن
comprise -> شامل می شود
consession -> رضایت
conciliate -> آشتی دادن
concord -> توافق
condensed -> متراکم شده است
confederate -> کنفدراسیون
confer -> اهدا کردن
confiscate -> مصادره کند
conform -> مطابقت داشته باشد
conjecture -> حدس
conjunction -> پیوستگی
consensus -> اجماع، وفاق
consignment -> محموله
consternation -> حیرت
constituent -> تشکیل دهنده
constrain -> محدود کردن
construe -> تعبیر کردن
consume -> مصرف کردن
contend -> مبارزه کردن
contentment -> قناعت
continual -> مستمر
contraceptive -> ضد بارداری
contrivance -> تدبیر
convey -> انتقال
co-operate -> همکاری کردن
co-ordinate -> هماهنگ كردن
coral -> مرجان
coronation -> تاج گذاری
correspond -> مطابقت
cosy -> دنج
countess -> کنتس
crater -> دهانه
crayfish -> خرچنگ
crease -> چین
creche -> مهدکودک
credulous -> ساده لوح
crescent -> هلال
crest -> تاج
croak -> غرغر کردن
crochet -> قلاب بافی
crockery -> ظروف سفالی
crumple -> مچاله کردن
crusade -> جنگ صلیبی
cudgel -> چماق
currant -> توت
cutlery -> کارد و چنگال
cutlet -> کتلت
cyber -> سایبر
cypress -> سرو
daffodil -> نرگس
dainty -> خوش طعم
dandelion -> قاصدک
dane -> دانمارکی
dangle -> آویزان شدن
daze -> گیج کردن
debit -> بدهی
deceit -> فریب
deduce -> استنباط
default -> پیش فرض
defer -> به تعویق انداختن
defiance -> سرپیچی
deficiency -> کمبود
deform -> تغییر شکل دادن
defrost -> یخ زدایی
degenerate -> منحط
degradation -> تنزل
deity -> خدایی
dejection -> دلتنگی
delicacy -> ظرافت
deluge -> سیل
demolish -> تخریب
demure -> فروتن
deplorable -> اسفناک
deport -> اخراج کردن
deprivation -> محرومیت
deride -> مسخره کردن
desirable -> مطلوب
desolate -> متروک
despot -> مستبد
deter -> بازداشتن
detergent -> مواد شوینده
detriment -> ضرر
devolution -> واگذاری
diarrhoea -> اسهال
dilate -> گشاد کردن
diligence -> سخت کوشی
diminish -> کاهش
disapproval -> عدم تایید
disbelief -> ناباوری
discard -> دور انداختن
disciple -> شاگرد
discomfort -> درد و ناراحتی
discredit -> بی اعتبار کردن
dismal -> ناامید کننده
dispatch -> ارسال
dissatisfaction -> نارضایتی
domicile -> اقامتگاه
dormitory -> خوابگاه
dowry -> مهریه
drape -> پرده
drizzle -> باران ریز و نمناک
drone -> پهپاد
drought -> خشکسالی
drowsy -> خواب آلود
dusk -> غروب
dutch -> هلندی
dynasty -> سلسله
dysentery -> اسهال خونی
earnings -> درآمد
easel -> سه پایه
edible -> خوراکی
egoism -> خودخواهی
embankment -> خاکریز
embark -> سوار شدن
embroider -> گلدوزی کردن
empower -> قدرت دادن
endorse -> تایید و امضا
enrich -> غنی سازی
entail -> مستلزم
envisage -> پیش بینی
err -> اشتباه کن
escalator -> پله برقی
evasion -> گریز
excel -> برتری داشتن
exempt -> معاف
exhale -> بازدم
expedient -> مصلحت
expend -> خرج کردن
extinct -> منقرض شده
fable -> افسانه
faciliate -> تسهیل کند
falcon -> شاهین
fastidious -> ریزبین
fathom -> درک
feat -> شاهکار
feeble -> ضعیف
ferocious -> وحشی
fibre -> فیبر
fiddle -> کمانچه
fig -> شکل
fillet -> فیله
flake -> پوسته پوسته شدن
flask -> فلاسک
flippers -> باله ها
flourish -> شکوفا شدن
flute -> فلوت
foliage -> شاخ و برگ
fortress -> قلعه
frenzy -> دیوانگی
funnel -> قیف
gild -> طلا
gills -> آبشش
giraffe -> زرافه
girdle -> کمربند
gloss -> براق
gnat -> پشه
go-between -> میان
grope -> دست زدن
guile -> نیرنگ
gust -> وزش
haphazard -> اتفاقی
harness -> مهار
haze -> مه
hearth -> اجاق
hedge -> پرچین
helm -> سکان
heritage -> میراث
heron -> حواصیل
herring -> شاه ماهی
hew -> چو
highjack -> های جک
hind -> عقب
hurdle -> مانع
hurl -> پرتاب کردن
hybrid -> ترکیبی
icicle -> قندیل
ignoble -> حقیر
illuminate -> روشن کردن
imaginable -> قابل تصور
immense -> عظیم
imminent -> قریب الوقوع
immobile -> بی حرکت
immoderate -> نامتعادل
impatience -> بی حوصلگی
impossibility -> عدم امکان
imprison -> زندانی کردن
improbable -> غیر محتمل
imprudence -> بی تدبیری
impure -> نجس
inaccessible -> غیر قابل دسترس
inaccurate -> نادرست
inaudible -> غیر قابل شنیدن
inaugurate -> افتتاح
inclination -> تمایل
incomparable -> غیر قابل مقایسه
incompatible -> ناسازگار
incomprehensible -> غیر قابل درک
indecent -> ناشایست
indictment -> اعلام جرم
indifference -> بی تفاوتی
indigestion -> سوء هاضمه
infantry -> پیاده نظام
inflame -> ملتهب کردن
inflict -> ایجاد کند
influenza -> آنفولانزا
ingenious -> مبتکرانه
inhabit -> ساکن بودن
inhuman -> غیر انسانی
innumerable -> بی شمار
inoculate -> تلقیح کردن
inoffensive -> غیر توهین آمیز
in-patient -> بستری
inquire -> جویا شدن
inscribe -> نوشته
insensible -> نامحسوس
inseparable -> جدایی ناپذیر
insolence -> وقاحت
instalment -> قسط
insufficient -> ناکافی
insular -> جزیره ای
insulation -> عایق
interact -> تعامل داشتن
intermediary -> میانجی
intolerable -> غير قابل تحمل
intoxicate -> مست کردن
invaluable -> ارزشمند
invariable -> تغییر ناپذیر
irreparable -> غیر قابل جبران
irriplaceable -> غیر قابل تعویض
jackal -> شغال
jolly -> با نشاط
jubilee -> سالگرد
judicial -> قضایی
juggle -> شعبده بازی
justification -> توجیه
languish -> از بین رفتن
lark -> خرچنگ
lateral -> جانبی
lattice -> شبکه
leaden -> سربی
leech -> زالو
livelihood -> امرار معاش
loneliness -> تنهایی
madden -> دیوانه شده
maggot -> انگل
malignant -> بدخیم
malnutrition -> سوء تغذیه
mandate -> دستور
manhood -> مردانگی
manoeuvre -> مانور
manpower -> نیروی انسانی
mare -> مادیان
marvel -> شگفت زده کردن
mayonnaise -> سس مایونز
measles -> سرخک
mediate -> واسطه
melancholy -> مالیخولیا
minimize -> به حداقل رساندن
miscalculate -> اشتباه محاسبه کند
mischief -> مایه دردسر
misty -> مه آلود
misuse -> سوء استفاده
monastery -> صومعه
moor -> لنگر انداختن
mortify -> نابود کردن
mow -> چمن زنی
multicultural -> چند فرهنگی
mutton -> گوشت گوسفند
navigable -> قابل کشتیرانی
nitrogen -> نیتروژن
nobility -> اشرافیت
non-stop -> بدون وقفه
novice -> تازه کار
noxious -> مضر
null -> خالی
nutshell -> مخلص کلام
oats -> جو دو سر
obstinacy -> لجبازی
obstruct -> مانع
odious -> نفرت انگیز
odour -> بو
offhand -> بدون مقدمه، بداهه
onset -> شروع
onward -> به جلو
opaque -> مات
optical -> نوری
orator -> خطیب
orchid -> ارکیده
ore -> سنگ معدن
ostrich -> شترمرغ
padlock -> قفل
pagan -> بت پرست
palate -> کام
partridge -> کبک
peacock -> طاووس
peat -> ذغال سنگ نارس
pedigree -> شجره نامه
penetrate -> نفوذ کند
peril -> خطر
perish -> از بین رفتن
perpetual -> همیشگی
perseverance -> استقامت
pest -> آفت
pheasant -> قرقاول
pickpocket -> جیب بر
pier -> اسکله
placard -> پلاکارد
placid -> ارام
plank -> تخته
plough -> شخم زدن
pluck -> چیدن
poach -> شکار غیرقانونی
pollute -> آلوده کردن
porcelain -> ظروف چینی
pore -> منافذ
porous -> متخلخل
portuguese -> پرتغالی
potent -> قوی
poultry -> طیور
precarious -> پرمخاطره
predicament -> مخمصه
preface -> پیشگفتار
prehistoric -> ماقبل تاریخ
premium -> حق بیمه
preoccupation -> مشغله
preside -> ریاست
primrose -> پامچال
probability -> احتمال
procure -> تهیه کنند
prodigy -> شگفتی
prolific -> پربار
prolong -> طولانی کردن
prone -> دمر
propaganda -> تبلیغات
propulsion -> نیروی محرکه
prose -> نثر
protrude -> بیرون زده
province -> استان
proximity -> نزدیکی
prudence -> احتیاط
prunes -> آلو
psalm -> مزمور
pullover -> پلیور
radiance -> درخشندگی
radish -> تربچه
raincoat -> لباس بارانی
ramble -> پرسه زدن
rapture -> لذت بردن
ratification -> تصویب
readiness -> آمادگی
recoil -> پس زدن
recollect -> به یاد بیاور
reconstruct -> بازسازی
rectangle -> مستطیل
rectify -> اصلاح کردن
recycling -> بازیافت
redeem -> از گرو در اوردن
reed -> نی
refine -> پالودن
refuel -> سوخت گیری
refusal -> امتناع
rein -> افسار
relapse -> عود
relent -> تسلیم شدن
reluctance -> بی میلی
remnant -> باقی مانده
render -> ارائه دادن
repetition -> تکرار
reprint -> تجدید چاپ
reptile -> خزنده
repulse -> دفع کردن
requisite -> مورد نیاز
respiration -> تنفس
revision -> تجدید نظر
revolt -> شورش
rind -> پوست
ripple -> موج دار شدن
roadmap -> نقشه راه
roadside -> کنار جاده
rosy -> گلگون
rot -> پوسیدگی
rotate -> چرخاندن
rouge -> رژ گونه
salutation -> سلام
sanctify -> تقدیس کردن
sanitary -> بهداشتی
saturate -> اشباع کردن
savour -> مزه
sceptical -> مشکوک
sculptor -> مجسمه ساز
seam -> درز
seaman -> دریانورد
seashore -> ساحل دریا
sect -> فرقه
selfconfidence -> اعتماد به نفس
selfcontrol -> خود کنترلی
selfemployed -> خویش فرما
selfevident -> بدیهی است
selfportrait -> سلف پرتره
semicircle -> نیم دایره
sermon -> خطبه
serpent -> مار
shabby -> کهنه
shallow -> کم عمق
shawl -> شال
sickly -> مریض
sinister -> شیطانی
sinner -> گناهکار
skid -> لغزش
skim -> لاغری
slander -> تهمت زدن
sledge -> سورتمه
sleek -> براق
slogan -> شعار
sociable -> دوستانه
son-in-law -> داماد
soot -> دوده
soothe -> آرام کردن
sovereign -> پادشاه
sow -> بکار
spam -> هرزنامه ها
spaniard -> اسپانیایی
spanner -> آچار
sparrow -> گنجشک
speck -> لکه. خال
spinster -> چرخاننده
spire -> گلدسته
squint -> چشمک زدن
stair -> پله
stallion -> اسب نر
stammer -> لکنت زبان
staple -> اصلی
starch -> نشاسته
starvation -> گرسنگی
stingy -> خسیس
stub -> خرد
sturgeon -> ماهیان خاویاری
subdue -> رام کردن
submerge -> غوطه ور شدن
sulphur -> گوگرد
surpass -> پیشی گرفتن
susceptible -> مستعد
swarm -> ازدحام
swede -> سوئدی
swiss -> سوئیس
synonym -> مترادف
bastard -> حرامزاده
dumb -> بی عقل
hank -> هنک
trey -> تری
glen -> گلن
enjoying -> لذت بردن
pleased -> راضی
burns -> می سوزد
commissioner -> کمیسیونر، رئیس پلیس
vanquish -> مغلوب شدن
morgue -> سردخانه
autopsy -> کالبد شکافی
meow -> میو
freely -> آزادانه
racket -> راکت تنیس
overdue -> عقب افتاده
lacking -> فاقد
crock -> خمره
clamp -> گیره
canned -> کنسرو شده
bathtub -> وان حمام
artery -> شریان
warmer -> گرم تر
ravine -> دره
pushy -> زورگو
laughter -> خنده
grove -> بیشه
fastest -> سریع ترین
carrier -> حامل
auntie -> خاله
wiser -> عاقل تر
willingly -> با کمال میل
waltz -> والس
thinner -> نازکتر
swelling -> ورم
swat -> سوات
steroid -> استروئید
slate -> سنگ لوح
sentinel -> نگهبان
rookie -> تازه کار
rehearse -> تمرین کنید
quarterback -> کوارتربک
ledge -> طاقچه
justified -> تعدیل شده
hateful -> نفرت انگیز
doorway -> درگاه
admiral -> دریاسالار
wrestle -> کشتی گرفتن
velvet -> مخملی
span -> طول
mart -> مارت
manor -> عمارت
madman -> دیوانه
intriguing -> جذاب
idiotic -> احمق
enlighten -> روشن کردن
donut -> دونات
brunch -> صبحانه
bridesmaid -> ساقدوش عروس
barrister -> وکیل دادگستری
architect -> معمار
applause -> تشویق و تمجید
alongside -> در کنار
wretched -> بدبخت
smoothly -> به نرمی
plead -> لابه کردن
payoff -> بازده
jumpy -> پرش
intervention -> مداخله
hanging -> حلق آویز کردن
germ -> ریشه
freed -> آزاد شد
flashing -> چشمک زن
convent -> صومعه
captive -> اسیر
vanity -> غرور
skate -> اسکیت
preview -> پیش نمایش
perjury -> شهادت دروغ
parental -> والدین
onboard -> سوار
mugged -> دزدیده شده
maestro -> استاد
linen -> کتانی
gypsy -> کولی
grind -> آسیاب کردن
greasy -> چرب
estimate -> تخمین زدن
elementary -> ابتدایی
drastic -> شدید
dolly -> دالی
crow -> کلاغ
compatriot -> هموطن
cocky -> از خود راضی
sprung -> بهار
spotlight -> نور افکن
revealing -> آشکار شدن
racist -> نژاد پرست
preacher -> واعظ
piper -> پیپر
overly -> بیش از حد
locket -> قفل دار
jab -> ضربه زدن
hover -> شناور
endure -> تحمل کن
dim -> کم نور
chained -> زنجیر شده
booty -> غنیمت
wand -> چوبدستی
scrambled -> درهم ریخته
rattle -> لرزاندن
linked -> مرتبط
investor -> سرمایه گذار
hustle -> فشار
forensic -> پزشک قانونی
enthusiastic -> مشتاق
duct -> مجرا
devastating -> ویرانگر
democrat -> دموکرات
comeback -> بازگشت
cheaper -> ارزان تر
charter -> منشور
calling -> صدا زدن
blushing -> خجالت زدگی
yoga -> یوگا
wrecking -> ویران کردن
wits -> عقل
waffles -> کلوچه
virginity -> باکرگی
uninvited -> ناخوانده
unfaithful -> بی وفا
underwater -> زیر آب
reel -> قرقره
redhead -> مو قرمز
rave -> دیوانه
ongoing -> در دست اقدام
lesser -> کمتر
lent -> قرض داد
jog -> دویدن
jingle -> جرنگ جرنگ
itch -> خارش
intellectual -> پر فکر
installed -> نصب شده است
indefinitely -> به طور نامحدود
genetically -> از نظر ژنتیکی
fireman -> مامور اتش نشانی
faculty -> دانشکده
discretion -> اختیار
declaration -> اعلام
crate -> جعبه
competent -> صالح
breaker -> شکن
bakery -> نانوایی
asylum -> پناهندگی
wedge -> گوه
unfit -> نامناسب
tuxedo -> تاکسیدو
torment -> عذاب
superhero -> ابرقهرمان
stirring -> هم زدن
spinal -> ستون فقرات
server -> سرور
seminar -> سمینار
rabble -> غوغا
pneumonia -> پنومونی
perk -> امتیاز
owl -> جغد
override -> نادیده گرفتن
manslaughter -> قتل غیر عمد
lime -> اهک
lettuce -> کاهو
kinky -> گره خورده
instructor -> مربی
grieve -> غمگین شدن
gorilla -> گوریل
frustration -> نا امیدی
extensive -> گسترده
exploration -> اکتشاف
authentic -> معتبر
arraignment -> محاکمه
tighter -> محکم تر
suitable -> مناسب
specimen -> نمونه
solving -> حل کردن
overprotective -> بیش از حد محافظ
identification -> شناسایی
grandchild -> نوه
genuinely -> واقعا
founded -> تاسیس شد
flushed -> برافروخته
floss -> نخ دندان
dove -> کبوتر
decorated -> تزئین شده است
crunch -> کروچیدن
cramp -> گرفتگی
corny -> کرنی
connecting -> برقراری ارتباط
bunk -> تختخواب
bitten -> گاز گرفته شده
ultrasound -> سونوگرافی
ultimatum -> اولتیماتوم
retrieve -> بازیابی
multi -> چند
millionaire -> میلیونر
mechanical -> مکانیکی
hiking -> پیاده روی
hatchet -> دریچه
doubtful -> مشکوک
dedication -> فداکاری
cellular -> سلولی
butterfly -> پروانه
biopsy -> بیوپسی
whiz -> ویز
voluntarily -> به طور داوطلبانه
ventilator -> هواکش
unload -> تخلیه
universal -> جهانی
toad -> غوک
snitch -> دزدیدن
sap -> شیره
reassure -> اطمینان دادن
prey -> طعمه
mystical -> عرفانی
mayhem -> ضرب وشتم
matrimony -> ازدواج
magnet -> آهن ربا
curly -> فرفری
cupid -> کوپید
comrade -> رفیق
bragging -> لاف زدن
aircraft -> هواپیما
adjusted -> تنظیم شده
vaguely -> به طور مبهم
tying -> گره زدن
slash -> بریده بریده
sigh -> آه
setback -> عقب گرد
retail -> خرده فروشی
melting -> ذوب شدن
mar -> مارس
lair -> لانه
hag -> هول
fury -> خشم
felicity -> سعادت
fang -> نیش
expelled -> اخراج کرد
decoration -> تزیین
cola -> کولا
blackout -> خاموشی
believable -> قابل باور
backfire -> نتیجه معکوس
vista -> چشم انداز
vintage -> قدیمی
urn -> کوزه در دار
slimy -> لزج
renting -> اجاره
reign -> سلطنت کنند
mailbox -> صندوق پستی
informant -> خبرچین
elf -> جن
disconnect -> قطع شدن
designing -> طراحی
crooked -> کج شده
crook -> خم کردن
conveniently -> به راحتی
colon -> روده بزرگ
warp -> پیچ و تاب
tacky -> چسبناک
steering -> فرمان
stability -> ثبات
reset -> تنظیم مجدد
radius -> شعاع
opener -> درب بازکن
mash -> له کردن
festive -> جشن
desperation -> ناامیدی
critic -> منتقد
consulting -> مشاوره
bagel -> شیرینی شیرینی پزی
authorization -> مجوز
agitate -> به هم زدن
wishful -> آرزومند
wimp -> لم دادن
unbearable -> غیر قابل تحمل
tonic -> مقوی
suction -> مکش
sporting -> ورزشی
safest -> امن ترین
oval -> بیضی شکل
newlywed -> تازه ازدواج کرده
nauseous -> حالت تهوع
misguided -> گمراه شده
mildly -> به صورت ملایم
liable -> مسئول
introducing -> معرفی
hen -> مرغ
dislike -> دوست نداشتن
diploma -> دیپلم
delude -> توهم
crummy -> خامه ای
contraction -> اختصار
carve -> تراشیدن
bottled -> بطری شده
bash -> ضربه شدید
unavailable -> غیر قابل دسترسی
twenties -> دهه بیست
trustworthy -> قابل اعتماد
stupidity -> حماقت
remorse -> پشیمانی
preferably -> ترجیحا
photography -> عکاسی
outsider -> خارجی
operational -> عملیاتی
northwest -> شمال غربی
mule -> قاطر
mourn -> سوگواری
mechanism -> سازوکار
mafia -> مافیا
greece -> یونان
greatness -> عظمت
girlie -> دختر بچه
delirious -> هذیان آور
cubicle -> اتاقک
check-up -> چک آپ
certified -> گواهی شده
automobile -> خودرو
athletic -> ورزشی
windscreen -> شیشه جلو
viper -> افعی
starring -> ستاره دار
spear -> نیزه
slit -> شکاف
serenity -> آرامش
roar -> غرش
quarry -> صید
prosecutor -> دادستان
probe -> پویشگر
potentially -> به طور بالقوه
poodle -> پودل
pitiful -> رقت انگیز
persistent -> مداوم
perception -> ادراک
neighbourhood -> محله
nagging -> آزار دهنده
masterpiece -> شاهکار
limbo -> برزخ
karate -> کاراته
irritating -> آزار دهنده
incline -> متمایل شدن
hump -> قوز
holler -> ناله
haw -> هاو
gauge -> پیمانه
fiasco -> شکست مفتضحانه
fallout -> سقوط
educational -> آموزشی
destination -> مقصد
crimson -> زرشکی
continent -> قاره
cider -> شراب سیب
brochure -> بروشور
behaviour -> رفتار - اخلاق
bargaining -> چانه زنی
awe -> هیبت
arena -> عرصه
wiggle -> تکان دادن
welcoming -> استقبال کردن
villain -> شرور
smear -> اسمیر
resentment -> رنجش
penguin -> پنگوئن
panther -> پلنگ
overhear -> شنیدن
mounted -> نصب شده است
morality -> اخلاق
leopard -> پلنگ
lab -> آزمایشگاه
jackpot -> برنده تمام پولها
icy -> یخی
hoot -> داغ کردن
handshake -> دست دادن
grilled -> کباب شده
formality -> رسمی
elevator -> آسانسور
bypass -> میان بر
breeding -> پرورش
boxer -> بوکسور
binding -> الزام آور
audio -> سمعی
acre -> هکتار
accidental -> تصادفی
ulterior -> باطن
tangle -> گره زدن
sought -> جستجو کرد
softball -> سافت بال
snag -> گیر
smallest -> کوچکترین
sling -> زنجیر
rumour -> شایعه
remarried -> دوباره ازدواج کرد
reluctant -> بی میل
puddle -> گودال
perceptive -> درخشان
oral -> دهانی
miraculous -> معجزه آسا
memorable -> بیاد ماندنی
maternal -> مادری
lookout -> مراقب باش
longing -> اشتیاق
lockup -> قفل کردن
lizard -> مارمولک
librarian -> کتابدار
junkie -> معتاد
immoral -> غیر اخلاقی
hypothetically -> بالفرض
extortion -> اخاذی
essentially -> اساسا
downright -> کاملا
digest -> هضم
cranberry -> زغال اخته
covert -> پنهانی
chorus -> گروه کر
bygone -> گذشته
buzzing -> وزوز
weary -> خسته
visa -> ویزا
viewer -> بیننده
uptown -> بالای شهر
tucker -> تاکر
transmitter -> فرستنده
tart -> تارت
taping -> نوار چسب زدن
takeout -> بیرون بردن
stepmother -> مادر خوانده
stale -> کهنه
pros -> طرفداران
merger -> ادغام
mandatory -> اجباری
ludicrous -> شگفت آور
inject -> تزریق کنید
dire -> وخیم
deceiving -> فریب دادن
caterer -> غذاساز
budge -> تکان دادن
vending -> فروشندگی
sexist -> جنسیتی
sanctuary -> جایگاه مقدس
regain -> به دست آوردن مجدد
processing -> در حال پردازش
picky -> ضربه زننده
misjudge -> قضاوت نادرست
miscarriage -> سقط جنین
mink -> راسو
memorize -> حفظ کردن
licking -> لیس زدن
lens -> لنز
jitter -> عصبانی شدن
invade -> حمله کردن
interruption -> وقفه
illegally -> به صورت غیر قانونی
glitch -> قطعی
fewer -> کمتر
doubly -> دو برابر
distraught -> پریشان
dispose -> در معرض قرار دادن
dagger -> خنجر
cruelty -> ظلم و ستم
cancelling -> لغو کردن
belonging -> متعلق
allegation -> ادعا
alias -> نام مستعار
aging -> سالخورده
zomby -> زامبی
slaughter -> ذبح
sensational -> پر شور
revolutionary -> انقلابی
par -> همتراز
overhead -> در بالای سر
oddly -> به طرز عجیبی
interrogate -> بازجویی کردن
imperative -> ضروری
impeccable -> بی عیب و نقص
hurtful -> آسیب زا
helper -> یاور
endangered -> در معرض خطر
dungeon -> سیاه چال
disgust -> انزجار
devious -> فریبنده
destruct -> نابود کردن
countdown -> شمارش معکوس
brotherhood -> برادری
brink -> لبه لبه
berry -> توت
banker -> بانکدار
ballroom -> سالن رقص
ark -> کشتی
annoyance -> مزاحمت
admirer -> ستایشگر
admirable -> قابل تحسین
activate -> فعال کردن
wed -> عروسی
weaver -> بافنده
valve -> شیر فلکه
twit -> توئیت
trout -> ماهی قزل آلا
slay -> ذبح کردن
sham -> شام
scrap -> باطله
resourceful -> مدبر
remarkably -> قابل توجه
refresh -> تازه کردن
puffy -> پف کرده
precaution -> احتیاط
pointy -> نوک تیز
nipple -> نوک پستان
ministry -> وزارت
hubby -> شوهر
flare -> شعله ور شدن
fierce -> شدید
demise -> مرگ
crushing -> خرد کردن
clinging -> چسبیده
checkbook -> دسته چك
cashmere -> ترمه
calmly -> با آرامش
believer -> مومن
amazingly -> شگفت آور
ultra -> فوق العاده
tolerance -> تحمل
tactical -> تاکتیکی
stairwell -> راه پله
spur -> تحریک
slower -> آهسته تر
sewing -> خیاطی
separately -> بطور جداگانه
restricted -> محصور
partially -> تا اندازه ای
mingle -> مخلوط شدن
knack -> مهارت
gullible -> زود باور
grid -> توری
folding -> تاشو
financially -> از نظر مالی
filming -> فیلمبرداری
eater -> خوار
dysfunctional -> ناکارآمد
dripping -> چکیدن
ditto -> همینطور
distinguished -> متمایز
defence -> دفاع
defeated -> شکست داد
corruption -> فساد
contractor -> پیمانکار
conceive -> حامله شدن
clone -> شبیه
circulation -> جریان
caliber -> کالیبر
brighten -> روشن کردن
banquet -> ضیافت
anticipate -> پیش بینی کنید
annoy -> آزار دادن
whim -> هوی و هوس
volatile -> فرار
veto -> وتو
successfully -> با موفقیت
severely -> به شدت، شدیدا
sage -> حکیم
runaway -> فرار کن
quarantine -> قرنطینه
premiere -> برتر
painless -> بدون درد
orphan -> یتیم
orphanage -> یتیم خانه
offence -> توهین
oasis -> واحه
nip -> نیش زدن
negotiation -> مذاکره
narcotic -> مواد مخدر
nag -> نق زدن
mistletoe -> دارواش
meddling -> مداخله کردن
manifest -> آشکار
loo -> لوو
intrigue -> دسیسه
injustice -> بی عدالتی
homicidal -> قتل
granny -> مادربزرگ
gigantic -> غول پیکر
dye -> رنگ
disturbance -> اختلال
disastrous -> فاجعه بار
demented -> زوال عقل
cosmic -> کیهانی
cheerful -> بشاش
brunette -> سبزه
beverage -> نوشیدنی
arcade -> گذرگاه طاقدار
unethical -> غیر اخلاقی
swollen -> متورم
swan -> قو
scalpel -> چاقوی کوچک جراحی
prototype -> نمونه اولیه
prop -> پشتیبانی
prescribe -> تجویز کند
pompous -> با شکوه
poetic -> شاعرانه
ploy -> ترفند
paw -> پنجه
manipulation -> دستکاری - اعمال نفوذ
lasting -> بادوام
keg -> بشکه
jell -> ژله
insignificant -> ناچیز
inmate -> زندانی
hasty -> عجولانه
grumpy -> بد خلق
fulfilled -> برآورده شد
evolution -> سیر تکاملی
discharged -> مرخص شد
disagreement -> اختلاف نظر
dine -> شام خوردن
dean -> رئیس
cornered -> گوشه
cork -> چوب پنبه
copied -> کپی شده است
confrontation -> تقابل
brightest -> درخشان ترین
banned -> ممنوع شد
attendant -> خدمتکار
athlete -> ورزشکار
amaze -> شگفت زده کردن
stuffy -> گرفتگی
sexuality -> جنسیت
segment -> بخش
revelation -> افشا
respirator -> دستگاه تنفس
pulse -> نبض
processed -> فرآوری شده
polygraph -> پلی گراف
ordinarily -> به طور معمول
morally -> از نظر اخلاقی
matrix -> ماتریس
martyr -> شهید
martial -> رزمی
invaded -> حمله کرد
homey -> خانه دار
heed -> توجه
heartbroken -> دل شکسته
groove -> شیار
greatly -> تا حد زیادی
forge -> ساختن
florist -> گل فروشی
firsthand -> دست اول
fiend -> شیطان
expanding -> در حال گسترش
drummer -> درامز
dandy -> شیک پوش
crippled -> فلج شده
craving -> میل شدید به
connote -> دلالت کند
conditioner -> نرم کننده
bubbly -> حباب دار
beeper -> بیپر
baptism -> غسل تعمید
ache -> درد
womb -> رحم
wiring -> سیم کشی
tummy -> شکم
surrogate -> جانشین
stray -> منحرف شدن
snob -> اسنوب
slowing -> کند شدن
scoot -> اسکات
scanner -> اسکنر
rightful -> برحق
richest -> ثروتمندترین
prophet -> نبی - پیامبر
paralysis -> فلج شدن
mellow -> ملایم
makeover -> تغییر شکل
jade -> یشم
interstate -> بین ایالتی
historic -> تاریخی
flock -> گله
disgusted -> منزجر
clam -> صدف
broadsheet -> برگه گسترده
brew -> دم کردن
borrowing -> قرض گرفتن
wildest -> وحشی ترین
unauthorized -> غیرمجاز
troll -> ترول
snatch -> قاپیدن
retro -> رترو
quilt -> لحاف
painfully -> دردناک
outlet -> پریز
mainland -> سرزمین اصلی
lonesome -> تنها
lawfully -> به طور قانونی
intercept -> رهگیری
hector -> هکتور
hamster -> همستر
grownup -> بالغ
goldfish -> ماهی قرمز
glued -> چسب
ghetto -> محله یهودی نشین
gait -> راه رفتن
delusion -> توهم
dart -> دارت
compelling -> متقاعد کننده
colonial -> استعماری
charitable -> خیریه
carton -> کارتن
boiling -> غلیان
bate -> باته
awaiting -> چشم انتظار
assign -> اختصاص دهد
arrogance -> تکبر
takeover -> به عهده گرفتن
synchronize -> همگام سازی
stalk -> ساقه
spleen -> طحال
spacecraft -> فضاپیما
slob -> لخت
prominent -> برجسته
prise -> جایزه
presumptuous -> متکبر
prejudice -> تعصب
platoon -> جوخه
pickle -> ترشی
permitted -> مجاز است
mush -> خمیر
mummy -> مومیایی
macaroni -> ماکارونی
legendary -> افسانهای
itinerary -> برنامه سفر
hepatitis -> هپاتیت
heave -> بالا بردن
gender -> جنسیت
fading -> محو شدن
dumbest -> احمق ترین
dishwasher -> ماشین ظرفشویی
descriptive -> توصیفی
cunning -> حیله گری
cripple -> فلج کردن
cove -> خور
compulsive -> اجباری
burglary -> سرقت
bumpy -> برآمده
blaze -> آتش
affirmative -> مثبت
adrenaline -> آدرنالین
unreal -> غیر واقعی
taint -> لکه دار کردن
spree -> ولگردی و قانونی شکنی
soak -> خیس خوردن
sever -> جداسازی
scarce -> کمیاب
scalp -> پوست سر
rewind -> باز پیچی
pretentious -> پرمدعا
planner -> برنامه ریز
placing -> قرار دادن
overrated -> مبالغه
loathe -> متنفر بودن
joker -> جوکر
heater -> بخاری
grin -> پوزخند
gospel -> انجیل
filter -> فیلتر
fertility -> باروری
exterior -> خارجی
epidemic -> بیماری همه گیر
enterprise -> شرکت، پروژه
emerald -> زمرد
ecstatic -> وجد
ecstasy -> خلسه
duly -> به درستی
distribution -> توزیع
clubhouse -> باشگاه
clot -> لخته خون
cheater -> متقلب
bursting -> ترکیدن
breather -> استراحت، تنفس
bending -> خم شدن
attendance -> حضور
arsonist -> آتش افروز
valiant -> شجاع
uphold -> حفظ کردن
unarmed -> غیر مسلح
thrilling -> هیجان انگیز
thigh -> ران
terminate -> خاتمه دادن
spiral -> مارپیچ
spaceship -> سفینه فضایی
salon -> سالن
ramp -> سطح شیب دار
quaint -> عجیب و غریب
patronize -> مشتری دائم بودن
patio -> پاسیو
paddle -> دست و پا زدن
mailman -> پستچی
joyous -> شادی آور
invincible -> شکست ناپذیر
interpret -> تفسیر
insecurity -> ناامنی
infamous -> بدنام
fragment -> قطعه
exploit -> بهره برداری
dusty -> گرد و خاکی
defy -> سرپیچی کردن
coy -> خجالتی
countless -> بی شمار
conjure -> التماس کردن
confine -> محدود کردن
chateau -> قلعه
blur -> تاری
bleach -> سفید کننده
beck -> بک
ban -> ممنوع کردن
backseat -> صندلی عقب
accomplishment -> دستاورد
wisely -> عاقلانه
wildlife -> حیات وحش
valet -> نوکر
vaccine -> واکسن
unnatural -> غیر طبیعی
tasting -> چشیدن
seducing -> اغوا کننده
secretive -> مخفیانه
screwdriver -> پیچ گوشتی
rightfully -> به درستی
poorly -> ضعیف
polling -> رای گیری
pedestal -> پایه
mystic -> عارف
miniature -> مینیاتوری
microscope -> میکروسکوپ
maple -> افرا
lantern -> فانوس
infinite -> نا محدود
incriminate -> متهم کردن
hygiene -> بهداشت
harp -> ساز چنگ
gage -> گیج
freight -> حمل و نقل
fore -> جلو
flooding -> جاری شدن سیل
eliminated -> حذف شده است
deacon -> شماس
cuter -> زیباتر
continental -> قاره
container -> ظرف
cavity -> حفره
capricorn -> برج جدی
atomic -> اتمی
wider -> گسترده تر
dumpling -> پیراشکی
underage -> زیر سن
truthfully -> صادقانه
tamper -> دستکاری کردن
statute -> اساسنامه
sparkling -> درخشان
sod -> چمن
socially -> اجتماعی
sideline -> حاشیه
rhinoceros -> کرگدن
railing -> نرده
puberty -> بلوغ
phantom -> فانتوم
pesky -> مزاحم
outrage -> خشم
openly -> بی پرده
nominate -> نامزد کردن
itching -> خارش
intuition -> بینش
icky -> یخ زده
humility -> فروتنی
fishy -> ماهی
finch -> فنچ
ferry -> کشتی
excessive -> بیش از اندازه
evolve -> تکامل یابد
eligible -> واجد شرایط
dosage -> دوز
disrupt -> مختل کردن
dipping -> فرو بردن
derange -> بی نظم
cuckoo -> فاخته
craziness -> دیوانگی
compatible -> سازگار
circumstantial -> شرایطی
bunker -> پناهگاه
asthma -> آسم
arise -> بوجود امدن
triad -> سه گانه
trashy -> زباله
tilt -> کج کردن
thorn -> خار
suburban -> حومه شهر
soothing -> آرامش بخش
slumber -> چرت
slayer -> قاتل
shindig -> مجلس رقص
sentiment -> احساسات
riddance -> رهایی
purity -> خلوص
offshore -> دریایی
massacre -> قتل عام
isolation -> انزوا
impersonal -> غیر شخصی
hoop -> حلقه
hamlet -> دهکده
footprint -> رد پا
fluke -> شانس
festivity -> جشن
feisty -> پر جنب و جوش
evacuate -> تخلیه
detain -> بازداشت
defender -> مدافع
creeping -> خزنده
classics -> کلاسیک ها
bud -> جوانه
bitterness -> تلخی
baloney -> بالنی
ashtray -> زیر سیگاری
apocalypse -> آخر الزمان
zillion -> میلیون
wan -> آنها
viable -> قابل دوام
sympathize -> همدردی کردن
squirt -> سرپیچ کردن
spade -> بیل
snappy -> تند
sleepover -> خوابیدن در خانه شخص دیگر
reunited -> دوباره متحد شد
retainer -> نگهدارنده
restroom -> دستشویی
repercussion -> پیامد
relive -> زنده کردن
reef -> تپه دریایی
reconciliation -> اصلاح
reconcile -> وفق دادن
recognise -> تشخیص
raven -> کلاغ سیاه
prevail -> غالب شدن پیروز شدن چیره شدن
preach -> موعظه
omen -> فال
noose -> طناب دار
meatloaf -> میت لوف
manicure -> مانیکور
landlady -> خانم صاحبخانه
hypothesis -> فرضیه
homesick -> دلتنگ
hive -> کندو
hectic -> گیج کننده
heartbreak -> دل شکستن
haunting -> فراموش نشدنی
gall -> صفرا
frown -> اخم
fingerprint -> اثر انگشت
extract -> استخراج کردن
expire -> منقضی شود
exhausting -> طاقت فرسا
exceptional -> استثنایی
disregard -> بی توجهی
crisp -> ترد
cooperative -> تعاونی
cling -> چسبیدن
blender -> مخلوط کن
bitty -> تلخ
bead -> مهره
badger -> گورکن
arch -> قوس
anticipation -> پیش بینی
advocate -> مدافع
waterfront -> اسکله
upstanding -> سربلند
unprofessional -> غیر حرفه ای
unhealthy -> ناسالم
turmoil -> آشفتگی
truthful -> راستگو
toothpaste -> خمیر دندان
thoughtless -> بی فکر
spun -> چرخید
spook -> ترساندن
shady -> سایه دار
senseless -> بدون احساس
scooter -> اسکوتر
ringer -> زنگ
refuge -> پناه
pun -> جناس
preposterous -> مضحک
portable -> قابل حمل
pastry -> شیرینی
loner -> تنها
jogging -> دویدن
itchy -> خارش‌دار
insinuate -> القا کردن
hospitality -> مهمان نوازی
forthcoming -> آینده
excess -> اضافی
etiquette -> آداب معاشرت
ending -> پایان یافتن
edit -> ویرایش کنید
dunk -> غوطه ور شدن
distinction -> فرق - تمیز - تشخیص
desist -> دست کشیدن
deprive -> محروم کردن
cloak -> شنل
casserole -> قابلمه
beaver -> سگ ابی
bearer -> حامل
applaud -> کف زدن
appalling -> مخوف
trump -> ترامپ
trench -> سنگر
touchdown -> تاچ داون
thaw -> آب شدن
tailor -> خیاط
swoop -> حرکت کردن
sticker -> استیکر
smite -> ضربه زدن
shameless -> بی حیا
researching -> تحقیق کردن
reclaim -> بازپس گیری
purposely -> به عمد
proxy -> پروکسی
pineapple -> آناناس
parasite -> انگل
offspring -> فرزندان
multiply -> تکثیر کردن
masculine -> مردانه
hoax -> حقه
gunfire -> تیراندازی
furnace -> کوره
flyer -> بروشور
engrave -> حکاکی کردن
duplicate -> تکراری
dome -> گنبد
designate -> تعیین کنید
delicatessen -> اغذیه فروشی
cryptic -> مرموز
creed -> عقیده
condemn -> محکوم کردن
colossal -> غول آسا
clipper -> قیچی
cliché -> کلیشه ای
clarity -> وضوح
banish -> تبعید کردن
argon -> آرگون
unicorn -> اسب تک شاخ
uncanny -> غیر طبیعی
treasury -> خزانه داری
technicality -> فنی
static -> ایستا
scales -> ترازو
satin -> ساتن
rosebud -> غنچه رز
relentless -> بی امان
rearrange -> تنظیم مجدد
plunge -> غوطه
obsolete -> منسوخ شده
moth -> پروانه
mindless -> بی فکر
lullaby -> لالایی
layout -> چیدمان
knob -> دستگیره
grown up -> بزرگ شده
flashy -> پر زرق و برق
epic -> حماسه
encode -> رمزگذاری
dread -> وحشت
doodle -> ابله
dealing -> معامله
cupcake -> کیک کوچک
console -> کنسول
conclusive -> قطعی
bowel -> روده
aura -> هاله
ape -> بوزینه
announcing -> اعلام می کند
abide -> پایبند بودن
wonderfully -> به طرز شگفت انگیزی
warfare -> جنگ
wad -> واد
violate -> نقض
suicidal -> خودکشی
skilled -> ماهر
sketchy -> طرح دار
shoplifting -> دزدی از فروشگاه
quizmaster -> استاد مسابقه
profitable -> سودآور
politically -> از نظر سیاسی
peck -> نوک زدن
needless -> بی نیاز
momentarily -> لحظه ای
midget -> خردسال
mercury -> سیاره تیر
leukemia -> سرطان خون
idol -> بت
fungus -> قارچ
extraction -> استخراج
explorer -> کاوشگر
chimera -> واهی
cheery -> شاد
cadet -> کادت
benign -> خوش خیم
artillery -> توپخانه
apiece -> یک تکه
abduction -> آدم ربایی
virtual -> مجازی
unspeakable -> ناگفتنی
unlimited -> نامحدود
unidentified -> ناشناس
twinkle -> چشمک زدن
transcript -> رونوشت
temp -> دما
surfing -> موج سواری
stricken -> زده
stork -> لک لک
sodium -> سدیم
snick -> اسنیک
sly -> حیله گر
retrieval -> بازیابی
quickie -> سریع
playboy -> پلی بوی
observer -> مشاهده کننده
mope -> موپ
moan -> ناله
mausoleum -> مقبره
kangaroo -> کانگورو
intensive -> متمرکز
infest -> آلوده کردن
incompetence -> بی کفایتی
horrified -> وحشت زده
grunt -> غرغر کردن
fracture -> شکست، شکستگی
formerly -> سابق
fireball -> گلوله آتشین
firearm -> اسلحه گرم
fend -> دفع کردن
examiner -> ممتحن
elite -> نخبه
duke -> دوک
dashing -> باهوش
curry -> ادویه کاری
crumb -> خرده نان
crash down -> سقوط کردن
courier -> پیک
conclude -> نتیجه گرفتن
cockroach -> سوسک
boulevard -> بلوار
bookie -> کتابدار
baptize -> غسل تعمید دادن
astronaut -> فضانورد
allegiance -> وفاداری
aiming -> هدف گیری
workplace -> محل کار
weave -> بافت
weaker -> ضعیف تر
suffocate -> خفه کردن
stench -> بوی تعفن
stark -> شدید
spawn -> تخمریزی
sideway -> کناری
shortcut -> میانبر
roam -> پرسه زدن
repulsive -> دافعه
provoke -> تحریک
plum -> آلو
penitentiary -> ندامتگاه
norm -> هنجار
milligram -> میلی گرم
midge -> میخ
lapse -> سپری شدن
knuckle -> بند انگشت
intercourse -> مقاربت
improvise -> بداهه
implant -> ایمپلنت
hometown -> زادگاه
handicap -> معلول
giddy -> سرگیجه
garland -> گلدسته
gallant -> شجاع
furry -> خزدار
fruitful -> مثمر ثمر
footing -> پایه
flop -> فلاپ
finding -> یافته
fib -> فیب
editorial -> سرمقاله
discovering -> کشف کردن
detour -> انحراف
cuddle -> در اغوش گرفتن
cub -> توله
coordinate -> هماهنگ كردن
collector -> گردآورنده
bane -> نابودی
bailiff -> ضابط
auditioning -> تست زنی
aching -> دردناک
woe -> وای
usher -> طلیعه
typically -> معمولا
tug -> کشیدن
topless -> برهنه
squid -> ماهی مرکب
soy -> سویا
snowman -> آدم برفی
sensor -> سنسور
seller -> فروشنده
renown -> شهرت
reflex -> رفلکس
recruiting -> استخدام
raisin -> کشمش
racial -> نژادی
pyramid -> هرم
preservation -> حفظ
portfolio -> نمونه کارها
pilgrim -> زائر
patriot -> میهن پرستان
oversight -> نظارت
merciful -> رحیم - مهربان
magistrate -> قاضی
intimidating -> ارعاب کننده
infirmary -> درمانگاه
inconvenient -> نامناسب
imposter -> متقلب
godforsaken -> رها شده از خدا
funk -> فانک
forgery -> جعل
foolproof -> بی اشتباه
folder -> پوشه
flattery -> چاپلوسی
fingertip -> نوک انگشت
exterminator -> نابودگر
eccentric -> عجیب و غریب
dodgy -> خجالتی
constructive -> سازنده
compartment -> محفظه
bodily -> بدنی
armour -> زره پوش
alimony -> نفقه
accustomed -> عادت کرده
wallow -> غوطه ور شدن
vicinity -> مجاورت، همسایگی
venue -> محل
upgrade -> ارتقا دهید
upcoming -> آینده
untrue -> نادرست
uncover -> برملا کردن
twig -> شاخه
trembling -> لرزیدن
taunt -> طعنه
tar -> تار
strand -> رشته
seizure -> تصرف
savvy -> باهوش
rile -> غرغر
revive -> احیای
retard -> عقب مانده
recruit -> استخدام کردن
rationally -> منطقی
provenance -> منشأ
prestigious -> معتبر
perky -> باحال
pedal -> پدال
overdose -> مصرف بیش از حد
nasal -> بینی
mushy -> خیس
mover -> حرکت دهنده
moot -> مورد بحث
melodramatic -> ملودراماتیک
medic -> پزشکی
manure -> کود کشاورزی
magnetic -> مغناطیسی
knockout -> ناک اوت
knitting -> بافندگی
idle -> بیکار
hotline -> خط تلفن
hammock -> ننو
framing -> کادر بندی
flap -> فلپ
flannel -> فلانل
existing -> موجود
eavesdrop -> استراق سمع کردن
dwarf -> آدم کوتوله
doggy -> سگ سگ
constellation -> صورت فلکی
collision -> برخورد
chic -> شیک
bleak -> تاریک
blacked -> سیاه شده
batter -> خمیر
archer -> کماندار
ante -> قبل از
aggravate -> تشدید - مشدد
vocal -> آوازی
unwind -> باز کردن از پیچ
twitch -> تکان دادن
taxpayer -> مالیات دهنده
reinforce -> تقویت کردن
dew -> شبنم
dictation -> دیکته
dilute -> رقیق کردن
disintegrate -> متلاشی شدن
disposable -> قابل عرضه
disqualify -> رد صلاحیت
dissolve -> حل کردن
distinguish -> تمیز دادن
doctrine -> دکترین
dolphin -> دلفین
dominant -> غالب
dominate -> تسلط داشتن
downward -> رو به پایین
drench -> خیس کردن
dub -> دوبله
dynamic -> پویا
earlobe -> لاله گوش
ebony -> آبنوس
ecology -> بوم شناسی
egotistical -> خود پسندی
elated -> سرخوش
elitist -> نخبه گرا
eloquent -> شیوا
emphasize -> اهمیت دادن
enjoyable -> لذت بخش
fahrenheit -> فارنهایت
flirtatious -> معاشقه
gymnasium -> ورزشگاه
hallucinate -> توهم داشتن
incorporate -> گنجاندن
increasingly -> به طور فزاینده
ivy -> پیچک
jigsaw -> اره منبت کاری اره مویی
locomotive -> لوکوموتیو
materialistic -> مادی گرا
parliamentary -> پارلمانی
parlour -> سالن
pastel -> پاستل
precipitation -> ته نشینی
predicate -> محمول
prediction -> پیش بینی
prefecture -> استان
procession -> راهپیمایی
prohibit -> ممنوع کرده است
protestant -> معترض
quotation -> نقل قول
realization -> تحقق
recession -> رکود اقتصادی
recreation -> تفریحی
reorganize -> سازماندهی مجدد
repetitious -> تکراری
reproduction -> تولید مثل
whereby -> به موجب آن
saxophone -> ساکسیفون
scallion -> پیازچه
sesame -> کنجد
aback -> متعجب
abash -> اباش
abate -> کاهش دادن
abdicate -> کناره گیری
abject -> افتضاح
absolve -> تبرئه کردن
abstain -> خودداری کنند
abundance -> فراوانی
acclaim -> تحسین
accrue -> تعلق می گیرد
accuracy -> دقت
acerbity -> شدت
acorn -> بلوط
acquit -> تبرئه
acrid -> بوی بسیار ناخوشایند
adjacent -> مجاور
adjoin -> مجاورت کردن
admonish -> نصیحت کردن
adroit -> چیره دست
adultery -> زنا
aerial -> هوایی
affinity -> قرابت
affliction -> مصیبت
affront -> توهین
aghast -> مبهوت
heather -> هدر
zeal -> غیرت
zoology -> جانور شناسی
yawn -> خمیازه
yeast -> مخمر
yolk -> زرده
yearn -> مشتاق بودن
wail -> ناله
whet -> خیس کردن
whimper -> ناله
whirlpool -> گرداب
willow -> درخت بید
wistful -> هوس انگیز
wreath -> تاج گل
wrest -> مچ گیری
wriggle -> خزیدن
wry -> عصبانی
vane -> پره
vehemence -> تندی
vexation -> ناراحتی
vivacious -> سرزنده
voracious -> حریص
udder -> پستان
up-to-date -> به روز
tapestry -> ملیله کاری
tardy -> ترسناک
thimble -> انگشتانه
throng -> ازدحام
thump -> ضربه زدن
thwart -> خنثی کردن
tinge -> ته رنگ
tinsel -> قلوه سنگ
tongs -> انبر
topple -> سرنگون کردن
transgress -> تجاوز کردن
treble -> سه برابر شدن
trifle -> چیز جزیی
truant -> فراری دادن
tumult -> غوغا
twine -> ریسمان
alight -> شعله ور
alignment -> هم ترازی
alleviate -> تخفیف دادن
amiable -> دوست داشتنی
annihilate -> نابود کردن
antler -> شاخ گوزن
arable -> قابل کشت
arid -> خشک
asunder -> شکافتن
audacious -> جسور
augment -> تقویت کردن
bayonet -> سرنیزه
beehive -> کندوی عسل
beseech -> التماس کردن
besiege -> محاصره کردن
bile -> صفرا
blemish -> عیب
blunder -> اشتباه بزرگ
boisterous -> پر شور
bough -> شاخه
brazen -> گستاخ
brevity -> اختصار
bristle -> برس
brittle -> شکننده
broth -> ابگوشت
buck -> دلار
bulging -> برآمده
callous -> بی احساس
caprize -> تسخیر کردن
caraway -> زیره سیاه
cloister -> صومعه
coexist -> همزیستی
confound -> گیج کردن
countenance -> صورت
covetous -> طمع
cower -> خفه کردن
crag -> صخره
crevice -> شکاف
crutch -> چوب زیر بغل
cumbersome -> سنگین
daub -> ضماد کردن
decadence -> انحطاط
den -> لانه
depict -> تصور کن
depot -> انبار
depreciate -> مستهلک شود
derivative -> مشتق
destitute -> بی بضاعت
deterrent -> بازدارنده
devaluation -> کاهش ارزش
devise -> تدبیر
devoid -> خالی
devour -> خوردن
devout -> عابد
diffident -> متفکر
digress -> منحرف شدن
dimple -> گودی
din -> دین
disarm -> خلع سلاح
discern -> تشخیص دادن
discontent -> نارضایتی
discord -> اختلاف
disdain -> تحقیر
disembark -> پیاده شدن
disfigure -> مخدوش کردن
dishearten -> ناامید کردن
dishonour -> بی حرمتی
disillusion -> سرخوردگی
disinterested -> بی علاقه
dismantle -> از بین بردن
dismount -> پیاده شدن
dispense -> توزیع
disperse -> پراکنده کردن
displace -> جابجا کند
displease -> نارضایتی
disquiet -> ناراحتی
dissipate -> از هم پاشیدن
distil -> تقطیر
distort -> تحریف کردن
distrust -> بی اعتمادی
diverge -> واگرا شدن
doleful -> کسالت بار
droop -> افتادن
dropper -> قطره چکان
drudgery -> سخت گیری
drunkard -> مست
dual -> دوگانه
dubious -> مشکوک
dummy -> ساختگی
dune -> تپه
dung -> سرگین
durable -> بادوام
edifice -> عمارت
eel -> مارماهی
efface -> محو کردن
effeminate -> زنانه
efficacious -> موثر
egyptian -> مصری
elapse -> گذشت
elegance -> ظرافت
elk -> گوزن
elusive -> گریزان
embezzlement -> اختلاس
emblem -> نشان
embody -> مجسم کردن
embryo -> جنین
emigrant -> مهاجر
eminence -> برجستگی
emit -> بیرون ریختن
emptiness -> پوچی
enact -> وضع
enamel -> مینای دندان
encircle -> محاصره کردن
enclose -> محصور کردن
encroach -> تجاوز کردن
encumber -> بار کردن
endeavour -> تلاش
endurance -> تحمل
enlist -> نام نویسی کردن
enliven -> زنده کردن
enmity -> دشمنی
enrage -> خشمگین کردن
enrapture -> مجذوب شدن
ensue -> به دنبال داشته باشد
entangle -> درهم تنیده
entice -> فریب دادن
entrails -> احشاء
entreat -> التماس کردن
entrust -> سپردن
enumerate -> برشمردن
enviable -> رشک برانگیز
envoy -> نماینده
epoch -> دوران
equanimity -> آرامش
equilibrium -> تعادل
eradicate -> ریشه کن کردن
evade -> طفره رفتن
evaporate -> تبخیر شود
ewe -> میش
exalt -> تعالی بخشید
excursion -> گشت و گذار
exemplify -> مثال زدن
expulsion -> اخراج
exaltation -> تعالی
falter -> لنگیدن
feign -> جعل کردن
ferment -> تخمیر
fern -> سرخس
fervent -> پرشور
feud -> دشمنی
fidelity -> وفاداری
fidget -> بی قراری
fiery -> آتشین
finnish -> فنلاندی
flax -> کتان
fleeting -> زودگذر
flicker -> سوسو زدن
flimsy -> سست
flippant -> تلنگر
flint -> سنگ چخماق
flog -> شلاق زدن
flounder -> دست و پا کردن
flutter -> بال بال زدن
fodder -> علوفه
foe -> دشمن
folly -> حماقت
forbear -> تحمل کردن
forefather -> پدر
forestall -> جلوگیر کردن
formidable -> مهیب
forsake -> رها کردن
fowl -> مرغ
frail -> نحیف
frantic -> از کوره در رفته
freckless -> بدون لک
frock -> روپوش
frontier -> مرز
froth -> کف کردن
frugal -> صرفه جو
furrow -> شیار
furtively -> مخفیانه
gaiety -> خوشبختی
gallop -> تاختن
gargle -> غرغره کردن
gaunt -> لاغر
gauntlet -> دستکش
gauze -> گاز پانسمان
gelatine -> ژلاتین
gem -> گوهر
genial -> دلپذیر
germinate -> جوانه زدن
ghastly -> وحشتناک
giddiness -> سرگیجه
gland -> غده
glaze -> لعاب
gleam -> سوسو زدن
glide -> سر خوردن
glimmer -> با روشنایی ضعیف تابیدن
glisten -> درخشش
glitter -> زرق و برق
glorify -> تجلیل کردن
gnaw -> مانند موش جویدن
granary -> انبار غلات
granite -> گرانیت
granulated -> دانه بندی شده
gratification -> رضایت
grating -> رنده کردن
gravitation -> جاذبه
graze -> چراندن
grimace -> ادا و اصول
grit -> شن
gruff -> خشن
grumble -> غر زدن
gulp -> قورت دادن
gurgle -> غرغر کردن
gush -> فوران
haberdashery -> مغازه ملبوس فروشی
haemorrhage -> خونریزی
haggard -> مضطرب
harmonious -> هماهنگ
harrow -> کلوخ شکن
haughty -> مغرور
haunch -> چنگ زدن
hazy -> مه آلود
heartburn -> سوزش سردل
heathen -> بت پرست
hem -> سجاف
hinge -> لولا
hiss -> هیس
hoard -> احتکار
hoarfrost -> سرمازدگی
hoof -> سم
hosiery -> جوراب بافی
howl -> زوزه کشیدن
hue -> رنگ
husk -> پوسته
immovable -> غیر منقول
impediment -> مانع
impel -> وادار کردن
impending -> قریب الوقوع
imperial -> امپراتوری
impertinent -> بی احترام
imperturbable -> غیرقابل اغتشاش
impetus -> انگیزه
implore -> التماس کردن
improper -> نامناسب
impunity -> بخشودگی
inability -> عجز
inadequate -> ناکافی
inadmissible -> غیر قابل قبول
inborn -> ذاتی
inconceivable -> غیر قابل تصور
inconsistency -> ناسازگاری
indebted -> بدهکار
indecision -> بلاتکلیفی
indefinite -> نامعین
indignant -> خشمگین
indispensable -> ضروری
indisputable -> بی چون و چرا
indistinct -> نامشخص
ineffective -> بی اثر
inefficient -> ناکارآمد
inert -> بی اثر
inestimable -> غیر قابل تخمین
inexhaustible -> تمام نشدنی
inexorable -> اجتناب ناپذیر
infallible -> خطاناپذیر
infatuated -> شیفته
infer -> نتیجه گیری
inferior -> پست تر
inflate -> باد کردن
influx -> هجوم
infringement -> نقض
infuriate -> خشمگین کردن
ingratitude -> ناسپاسی
injunction -> دستور
inopportune -> نامناسب
insoluble -> نامحلول
intrepid -> بی باک
involuntary -> غیر ارادی
iodine -> ید
irksome -> مزاحم
irreproachable -> غیر قابل ملامت
irrigate -> آبیاری
jack-knife -> جک چاقو
jagged -> ناهموار
javelin -> نیزه
jeer -> تمسخر
jest -> شوخی
jolt -> تکان خوردن
jovial -> شادی آور
judicious -> دارای قوه قضاوت سلیم
jut -> پرت کردن
keel -> قرقره
kernel -> هسته
kindle -> روشن شدن
know-how -> دانش
lacquer -> لاک
laden -> مملو
ladle -> ملاقه
lag -> تاخیر
lame -> لنگ
lament -> سوگواری
lash -> مژه
latch -> چفت
lathe -> ماشین تراش
lather -> کف کردن
laurel -> لورل
lavender -> اسطوخودوس
levy -> وضع مالیات
lilac -> بنفشه
lime-tree -> درخت لیمو
linger -> درنگ
locust -> ملخ
loin -> کمر
louse -> شپش
lubricant -> روان کننده
lukewarm -> ولرم
lull -> آرامش
luminous -> نورانی
luscious -> خوش طعم
lustre -> درخشش
luxuriant -> مجلل
magpie -> زاغی
maim -> معلول کردن
malt -> مالت
mammoth -> ماموت
mane -> یال
manuscript -> نسخه خطی
marten -> مارتن
mast -> دکل
meek -> ملایم
melon -> خربزه
militant -> ستیزه جو
mimic -> تقلید کردن
mince -> گوشت چرخ کرده
mirth -> شادی
mitten -> دستکش
morsel -> لقمه
montley -> مونتلی
muffle -> صدا خفه کن
mulberry -> شاه توت
mumble -> زمزمه کردن
mural -> نقاشی دیواری
musty -> کپک زده
mutilate -> مثله کردن
muzzle -> پوزه
nautical -> دریایی
neigh -> همسایه
nettle -> گزنه
niche -> موقعیت مناسب، جایگاه
nimble -> زیرک
nominal -> اسمی
noncommittal -> غیر متعهد
nondescript -> غیر توصیفی
nook -> گوشه
notwithstanding -> با وجود
oblique -> مورب
oblong -> مستطیل
oppress -> ظلم کردن
ostentatious -> خودنمایی
otter -> سمور سمور
quail -> بلدرچین
quaver -> تکان دادن
quay -> اسکله
quiver -> لرزش
paltry -> ناچیز
pang -> درد
pansy -> پانسی
pant -> شلوار
parch -> پارچ
pare -> پاره کردن
parish -> محله
parson -> کشیش
partition -> تقسیم بندی
patter -> نوازش کردن
patty -> پتی
peal -> پوست کندن
pebble -> سنگریزه
penal -> جزایی
pendulum -> آونگ
pensive -> متفکر
peppermint -> نعناع تند
perch -> نشستن
perplex -> گیج
persecute -> آزار و اذیت
perverse -> منحرف
phonebooth -> باجه تلفن
physique -> فیزیک بدن
pimple -> جوش
pitfall -> تله
plaice -> پلک
plaid -> چهارخانه
plaintiff -> شاکی
plait -> بافتنی
pleat -> پلیسه
plentiful -> فراوان
pliable -> قابل انعطاف
plight -> مصیبت
plod -> تخريب
plunder -> غارت کردن
plywood -> تخته سه لا
polarity -> قطبیت
ponder -> اندیشیدن
poplar -> صنوبر
posterity -> آیندگان
potter -> سفالگر
pouch -> کیسه
pounce -> پرتاب کردن
pout -> نفخ
prelude -> پیش درآمد
prerogative -> حق ویژه
pretence -> تظاهر
pretext -> بهانه، مستمسک
prism -> منشور
prologue -> مقدمه
propel -> سوق دادن
proprietary -> اختصاصی
proprietor -> مالک
provocation -> تحریک
pulp -> پالپ
pulverize -> پودر کردن
pungent -> تند
purr -> خرخر کردن
ragged -> ژنده پوش
rake -> شن کش
ram -> رم
rascal -> فضول
ravage -> ویران کردن
reap -> درو
rebuff -> رد کردن
rebuke -> سرزنش کردن
recline -> لم دادن
recompense -> پاداش
reconnaissance -> شناسایی
refrain -> خودداری
refutation -> رد
regent -> نایب السلطنه
rejoice -> شادی کردن
relinquish -> رها کردن
remittance -> حواله
rend -> رها کردن
repent -> توبه کردن
repress -> سرکوب کردن
reprimand -> توبیخ
reproach -> سرزنش
reproof -> توبیخ
resolute -> مصمم
resound -> طنین انداز
respite -> مهلت دادن
restoration -> مرمت
resurrection -> رستاخیز
retaliate -> تلافی کردن
reticence -> سکوت
retinue -> همراهی
retort -> پاسخ دادن
rhubarb -> ریواس
rift -> بریدگی
rite -> مناسک
rivet -> پرچ
roe -> قلیه
romp -> جست و خیز کردن
rook -> سر
rouse -> برانگیختن
rove -> طناب زدن
rowan -> روون
rudder -> سکان
ruffian -> روفی
rumble -> غرش
rummage -> زیر و رو کردن
rustic -> روستایی
rustle -> خش خش
rut -> شیار
sable -> سمور
sacrament -> مراسم مقدس
sag -> افتادگی
sagacious -> حکیمانه
sardine -> ساردین
satire -> طنز
scaffolding -> داربست
scald -> سوزاندن
scanty -> اندک
scorch -> سوزاندن
scoundrel -> رذل
scowl -> اخم کردن
scribble -> خط خطی کردن
scrupulous -> دقیق
scythe -> داس
seclude -> منزوی کردن
seethe -> جوشیدن
selfservice -> سلف سرویس
semblance -> ظاهر
sequel -> عاقبت
shaggy -> پشمالو
shear -> برشی
sherry -> شراب شیرین یا تلخ اسپانیولی
shingle -> زونا
shrill -> تیز
shrivel -> چروک شدن
shrub -> درختچه
shudder -> لرزیدن
shuffle -> بر زدن
shun -> اجتناب کنید
sickle -> داس
siege -> محاصره
sift -> الک کردن
sill -> آستانه
silliness -> حماقت
sinew -> سینه
singe -> آواز خواندن
skipper -> کاپیتان
skirmish -> تکان خوردن
sluice -> دریچه
slush -> لجن
smother -> خفه کردن
smoulder -> دود کردن
snarl -> غرغر کردن
sneer -> تمسخر
snort -> خرخر کردن
snout -> پوزه
snug -> راحت
solder -> لحیم کاری
soloist -> تکنواز
soluble -> محلول
spatter -> پاشیدن
spectrum -> طیف
spinach -> اسفناج
spittle -> تف
splinter -> ترکش
sprinter -> دونده سرعت
squeak -> جیر جیر
stagger -> تلو تلو خوردن
standpoint -> دیدگاه
staunch -> استدلال
steed -> اسب
steeple -> برج
steppe -> استپی
sterile -> استریل
steward -> مباشر
stifle -> خفه کردن
stipulate -> شرط می کند
stocking -> جوراب ساق بلند
stoker -> استوکر
stout -> چاق و چله
stow -> انبار کردن
strenuous -> سخت
strew -> ریختن
stripe -> راه راه
strive -> تلاش کردن
stubble -> کلش
stump -> کنده
stupendous -> شگفت انگیز
sturdy -> محکم
stutter -> لکنت
subdivide -> تقسیم کردن
subside -> فروکش کند
subsist -> زندگی کردن
suede -> جیر
sulk -> اخم
sullen -> عبوس
sultry -> داغ
sumptuous -> مجلل
sunken -> غرق شده
superfluous -> زیادی
superintend -> سرپرست
superintendent -> سرپرست
supersede -> جایگزین کردن
supplant -> جایگزین کردن
supple -> انعطاف پذیر
suppress -> سرکوب کردن
surmise -> حدس و گمان
surmount -> غلبه کردن
swarthy -> تیره
sway -> تاب خوردن
swerve -> منحرف شدن
swindle -> کلاهبرداری
swine -> گراز
synthesis -> سنتز
zealot -> متعصب
zealous -> غیرتمند
zenith -> اوج
zigzag -> زیگ زاگ
zodiac -> زودیاک
yank -> یاک
yap -> یاپ
yelp -> فریاد زدن
yoke -> یوغ
yowl -> زوزه
abattoir -> کشتارگاه
abbot -> ابات
abed -> تختخواب
abberance -> اببرانس
abberant -> نابسامان
abet -> شریک
abhor -> بیزاری
abhorrence -> بیزاری
abhorrent -> نفرت انگیز
abjection -> خواری
abjure -> چشم پوشی کردن
ablative -> منسوخ کننده
ablaze -> مشتعل
able-bodied -> توانمند
ably -> توانا
abnegate -> نفی کردن
abnegation -> نفی
abnormality -> ناهنجاری
abolishment -> لغو
aboninable -> ناپسند
abonnement -> ربوده شدن
aboriginal -> بومی
aborigines -> بومیان
abortive -> ناقص
above-average -> بالاتر از حد متوسط
aboveboard -> بالای تخته
abrasive -> ساینده
abreast -> همگام
abridge -> خلاصه کردن
abruptness -> ناگهانی
absently -> غایب
absolution -> عفو
absorbing -> جذب کننده
abyss -> پرتگاه
accede -> ملحق شدن
acceleration -> شتاب
accolade -> تحسین
accommodating -> انطباق دادن
accompaniment -> همراهی
accordance -> مطابقت
accredited -> معتبر
accuser -> متهم کننده
acheless -> بی درد
achy -> دردناک
acne -> آکنه
acquisition -> تحصیل
adaptation -> انطباق
addressee -> مخاطب
adept -> ماهر
adherence -> تبعیت
admiration -> تحسین
admonishment -> تذکر
adornment -> زینت
adulate -> تحسین کردن
adulatory -> خیانت آمیز
adulthood -> بزرگسالی
advancement -> پیشرفت
adverse -> نامطلوب
adversity -> ناملایمات
advisedly -> توصیه شده
advocacy -> دفاع
affable -> دوست داشتنی
affluence -> ثروتمندی
affluent -> فراوان
afloat -> شناور
afterthought -> بعد فکر
aggregate -> تجمیع
agreeable -> قابل قبول
ail -> بیماری
ailment -> ناراحتی
aimless -> بی هدف
air-condition -> وضعیت هوا
airless -> بدون هوا
air-tight -> هوا بسته
airy -> هوادار
akin -> یکسان
alacrity -> نشاط
albeit -> هر چند
alcove -> طاقچه
alertness -> هوشیاری
allay -> آرام کردن
allocate -> اختصاص دهد
all-purpose -> همه منظوره
allure -> جذابیت
aloof -> دور
alteration -> تغییر
ambient -> محیط
ambiguity -> گنگ
amendable -> قابل اصلاح
amenity -> تسهیلات، رفاه
amoral -> غیر اخلاقی
amorphous -> بی شکل
amplify -> تقویت
amplitude -> دامنه
anchovy -> ماهی کولی
angrily -> با عصبانیت
anguish -> غم و اندوه
angular -> زاویه ای
annotation -> حاشیه نویسی
anoitment -> مسح
antagonize -> مخالفت کردن
antarctic -> قطب جنوب
antecedent -> پیشین
antenna -> آنتن
anteroom -> پیش اتاق
antisocial -> ضد اجتماعی
antiterrorist -> ضد تروریست
apathy -> بی تفاوتی
aplenty -> فراوان
apostrophe -> آپستروف
appal -> وحشتناک
appellation -> نامگذاری
append -> ضمیمه
appetizing -> اشتها آور
applicant -> درخواست کننده
appraisal -> ارزیابی
approbation -> موافقت رسمی
aptitude -> صلاحیت - استعداد - شایستگی
aptly -> به درستی
archery -> تیراندازی با کمان
archly -> قوس دار
ardently -> مشتاقانه
arduous -> سخت
armament -> تسلیحات
armature -> آرماتور
armless -> بدون بازو
armory -> اسلحه خانه
array -> آرایه
articulate -> بیان
artless -> بی هنر
artsy -> هنری
ascension -> عروج
ashy -> خاکستری
askew -> کج
asperity -> خوش بینی
aspirant -> مشتاق
assail -> حمله کردن
assort -> دسته بندی
assortment -> مجموعه ای
assuage -> آرام کردن
assumptive -> فرضی
assuredness -> اطمینان
astound -> مبهوت
atonement -> کفاره
atrocity -> قساوت
attachment -> پیوست
attentive -> توجه
attenuate -> تضعیف کردن
attest -> گواهی
attestation -> تصدیق
attire -> لباس
attrition -> فرسایش
attune -> هماهنگ کردن
aubergine -> بادمجان
audacity -> گستاخی
audibly -> به صورت شنیداری
auditory -> شنوایی
auspice -> فرهیختگی
avenge -> انتقام گرفتن
avert -> جلوگیری کند
avid -> مشتاق
avouch -> رای دادن
avow -> قول
aweless -> بی هیبت
axis -> محور
backache -> كمر درد
baggy -> کیسه دار
bagpipe -> کوله پشتی
balk -> مخالفت کردن
ballot -> ورقه رای
banal -> پیش پا افتاده
banter -> دست انداختن
baseless -> بی اساس
bashful -> خجالتی
basin -> حوضه
bask -> حمام کردن
bazaar -> بازار
beastly -> حیوانی
beautify -> زیبا کردن
bedding -> ملافه
bedevil -> شیطان
bedridden -> بستری
beefy -> گوشتی
befriend -> دوست شدن
beggarly -> گدایی
begrudge -> کینه توزی
bellow -> زیر
benefactor -> خیر
benevolence -> خیرخواهی
benevolent -> خیراندیش
benignity -> خیرخواهی
berth -> اسکله
beset -> گرفتار
bestial -> حیوانی
bestiality -> حیوانیت
bestow -> عطا کردن
bewitch -> جادو کردن
big-hearted -> سخاوتمند
bigot -> متعصب
bilingual -> دو زبانه
bite-size -> اندازه لقمه
blackcurrant -> توت سیاه
blackness -> سیاهی
blameless -> بی تقصیر
blare -> فریاد زدن
blaspheme -> توهین به مقدسات
blindly -> کورکورانه
blindness -> کوری
blissful -> سعادتمند
bloat -> نفخ کردن
blotch -> لکه
blubber -> غرغر شدن
bluffy -> بلوفی
bluish -> مایل به آبی
bluster -> غوغا کردن
boastful -> مغرور
bog -> باتلاق
bookcase -> قفسه کتاب
bookkeeper -> حسابدار
bookworm -> کرم کتاب
borough -> بخش
braid -> بهم تابیدن و بافتن
brainless -> بی مغز
brainpower -> قدرت مغز
brand-new -> کاملا نو
brash -> بی پروا
brilliance -> درخشش
brother-in-law -> برادر شوهر
brute -> بی رحم
built-in -> ساخته شده است
bystander -> تماشاچی
calmness -> آرامش
calumny -> بدگویی
candour -> رک بودن
capacious -> ظرفیت دار
captivate -> اسیر کردن
carbohydrate -> کربوهیدرات
carious -> پوسیدگی
carnivorous -> گوشتخوار
cast iron -> چدن
catchy -> جذاب
cater -> تهیه غذا
cattish -> گربه سان
caw -> گاو
ceasless -> بی وقفه
ceramic -> سرامیک
chafe -> چفیه
chagrin -> ناراحتی
chancy -> شانس
changeable -> تغییر پذیر
changeless -> بدون تغییر
chastise -> تنبیه کردن
chastisement -> تنبیه
chatterbox -> وراج
cheapen -> ارزان کردن
cheerless -> بی روح
chestnut -> فندق
childbirth -> زایمان
churchyard -> حیاط کلیسا
circular -> گرد
circumscribe -> حد و مرز گذاشتن
circumvent -> دور زدن
civic -> مدنی
clack -> کلاک
clairvoyant -> روشن بین
cleave -> شکافتن
cleaver -> چاقو
cleft -> شکاف
clemency -> رحم
clement -> ارامش
clergy -> روحانیت
clergyman -> روحانی
cleverness -> زیرکی
climax -> به اوج رسیدن
clinch -> گیره
cloakroom -> رخت کن
clog -> گرفتگی
closeness -> نزدیکی
clotted -> لخته شده
cloudless -> بدون ابر
clout -> نفوذ
cluster -> خوشه
clutter -> کلفت
cockpit -> کابین خلبان
coefficient -> ضریب
cogitate -> فکر کردن
cognate -> هم خانواده
cognizance -> شناخت
cohabit -> زندگی مشترک
cohere -> منسجم
cohort -> گروه
colander -> صافی
coldness -> سردی
collateral -> وثیقه
collective -> جمعی
collide -> برخورد
comely -> زیبا
commandment -> فرمان
commemorate -> بزرگداشت
commiserate -> دلسوزی
compulsion -> اجبار
concealment -> پنهان کاری
concede -> قبول کردن
concourse -> گردهمایی
concur -> هم رای بودن
concurrence -> توافق
condiment -> چاشنی
condole -> تسلیت
conductive -> رسانا
congest -> ازدحام
congestion -> تراکم، شلوغی
congruous -> متجانس
connate -> پیوند دادن
consecution -> متوالی
conserve -> کنسرو
cosign -> علامت گذاری کنید
constrict -> منقبض کردن
contagion -> سرایت
contaminate -> آلوده کردن
contemn -> تحقیر کردن
convene -> دور هم جمع شدن
cookery -> آشپزی
corpulent -> فاسد
cordial -> صمیمی
cornflower -> گل ذرت
correspondence -> مکاتبات
correlation -> همبستگی
credulity -> زودباوری
crimpy -> ترد
culinary -> آشپزی
dashboard -> داشبورد
daughter-in-law -> عروس
daunt -> دلهره آور
dauntless -> سرانداز
daydream -> رویاپردازی
debark -> پوست کندن
debatable -> قابل بحث
debauch -> فسق
decimal -> اعشاری
decisive -> تعیین کننده
decoction -> جوشانده
decompose -> تجزیه کنند
decree -> فرمان
deem -> به نظر
deep-rooted -> ریشه دار
deface -> خراب کردن
deference -> احترام
deficit -> کمبود
deliquency -> بزهکاری
demeanour -> رفتار
demolition -> تخریب
demote -> تنزل دادن
denote -> مشخص کن
denounce -> محکوم کردن
density -> تراکم
denunciation -> محکوم کردن
depart -> رفتن
deplete -> خالی کردن
deprave -> فاسد کردن
derelict -> متروکه
detestable -> نفرت انگیز
dietary -> غذایی
diffuse -> پراکنده
digestive -> گوارشی
dignify -> وقار دادن
dike -> دایک
dilapidation -> فرسودگی
dill -> شوید
dilution -> رقیق شدن
diminution -> کاهش
dimness -> تیرگی
dingy -> کثیف
directness -> مستقیم بودن
dirtiness -> آلودگی
disability -> ناتوانی
disarray -> بی نظمی
disavow -> انکار کردن
discernible -> قابل تشخیص
disciplinary -> انضباطی
discourse -> گفتمان
discourteous -> بی ادب
discrepancy -> اختلاف
disembody -> متلاشی شدن
disembroil -> متلاشی کردن
dish-water -> آب ظرف
disingenuous -> غیر صادقانه
disinherit -> سلب ارث
disloyal -> بی وفا
dismay -> ناراحتی
disobey -> نافرمانی
disparage -> تحقیر کردن
disparity -> نابرابری
disprove -> رد کردن
disreputable -> بی اعتبار
dissemble -> متلاشی کردن
dissimilar -> غیر مشابه
distasteful -> ناپسند
diverse -> گوناگون، متنوع
divert -> منحرف کردن
divinity -> الوهیت
doable -> شدنی
doer -> انجام دهنده
dog-collar -> قلاده سگ
domain -> دامنه
doormant -> دربان
draught -> پیش نویس
drawback -> اشکال
earlap -> گوش بند
earthy -> خاکی
eatable -> قابل خوردن
easygoing -> اسان گیر
edacity -> شجاعت
edacious -> خسته کننده
efforless -> بی تلاش
ejection -> بیرون ریختن
elemental -> عنصری
emasculate -> تنزل دادن
embitter -> تلخ
embodiment -> تجسم
eminent -> برجسته
emulate -> تقلید
encase -> محصور کردن
endorsement -> تایید
enfold -> در بر گرفتن
enigma -> معما
ensign -> پرچمدار
enthrone -> بر تخت نشستن
equability -> برابری
equality -> برابری
equity -> انصاف
erratic -> دمدمی مزاج
espionage -> جاسوسی
estrange -> غریبه
eventful -> پر حادثه
evergreen -> همیشه سبز
evoke -> برانگیختن
exasperate -> عصبانی
excavate -> حفاری کردن
exclusion -> محرومیت
excrete -> دفع کردن
excruciation -> شکنجه
exemplar -> نمونه
facile -> آسان
facultative -> اختیاری
fad -> مد زودگذر
fairness -> انصاف
fairytale -> افسانه
faithless -> بی ایمان
falsify -> جعل کردن
far-fetched -> دور از ذهن
father-in-law -> پدر شوهر
faultless -> بی عیب
fearsome -> ترسناک
feasible -> شدنی
feint -> ظاهری
fell -> سقوط
fellowship -> معاشرت
fen -> فنس
fervid -> پرشور
fetid -> متعفن
feudal -> فئودال
fickle -> بی ثبات
finesse -> ظرافت
fire-extinguisher -> کپسول آتش نشانی
firstly -> اولا
fitful -> ناخوشایند
fixedly -> به طور ثابت
fixture -> ثابت
fizzy -> گازدار
flabby -> شل و ول
flamboyant -> پر زرق و برق
flank -> جناح
flatly -> صاف
fleck -> فلک
flex -> خم شدن
floral -> گلدار
fluency -> روانی
flurry -> سر و صدا
foggy -> مه آلود
foetus -> جنین
foil -> فویل
follower -> دنباله رو
fondle -> نوازش کردن
fondness -> علاقه
footwear -> کفش
forceful -> نیرومند
forceless -> بی زور
forearm -> ساعد
foresee -> پیش بینی
foresight -> آینده نگری
foretaste -> پیش مزه کردن
forgetful -> فراموشکار
forum -> انجمن
foster-child -> فرزندخوانده
frigility -> شکنندگی
fraudulent -> جعلی
freelance -> آزاد
frivolous -> بیهوده
frizz -> موخوره
frontage -> نمای جلو
frugality -> صرفه جویی
fruitless -> بی ثمر
gabble -> غرغر کردن
gaily -> شادی آور
gainful -> سودآور
gateway -> دروازه
gaudy -> زرنگ
gist -> اصل مطلب
glare -> تابش خیره کننده
gleeful -> خوشحال
glossary -> واژه نامه
glum -> غمگین
glutton -> پرخور
gluttony -> شکم پرستی
goblet -> جام
godless -> بی خدا
goggle -> عینک
gorge -> تنگه
gossipy -> شایعه پراکنی
governess -> حاکم
graceless -> بی لطف
grate -> رنده کردن
groin -> کشاله ران
groundless -> بی اساس
growl -> غرغر کردن
grub -> گراب
gruel -> قرقره
hailstone -> تگرگ
hairdresser -> آرایشگاه
half-baked -> نیم پز
half-brother -> برادر ناتنی
half-moon -> نیمه ماه
half-time -> نیمه وقت
half-year -> نیم سال
halve -> نصف کردن
hamper -> مانع
handgrip -> دستگیره
handicraft -> هنر دستی
hangnail -> میخ
hard-boiled -> سخت جوشانده
harden -> سفت شدن
hardily -> به سختی
hardness -> سختی
hardship -> سختی
hare -> خرگوش
headlight -> چراغ جلو
headphone -> هدفون
heady -> سرگیجه
heartily -> از صمیم قلب
heedless -> غافل
heiress -> وارث
heirloom -> ارثیه
hermic -> هرمیک
hibernate -> خواب زمستانی
hiccup -> سکسکه
hindrance -> مانع
hindsight -> واپس نگری
hireling -> استخدام
hobble -> تکان دادن
housemaid -> خدمتکار خانه
hugely -> به شدت
humankind -> نوع بشر
humid -> مرطوب
husky -> هاسکی
hysteria -> هیستری
icily -> یخی
icon -> آیکون
illegible -> ناخوانا
illegimate -> نامشروع
illicit -> قاچاق
illusive -> توهم آمیز
imbue -> غرق کردن
immaculate -> معصوم
immensely -> به شدت
immerse -> غوطه ور کردن
impassable -> صعب العبور
imperfect -> ناقص
impetuous -> پر شور
impish -> بی حیا
implacable -> تسلیم ناپذیر
impregnable -> رسوخ ناپذیر
imprint -> حک
inaction -> بی عملی
inadequacy -> بی کفایتی
inane -> احمقانه
inapptitude -> بی استعدادی
inattentive -> بی توجه
indelicate -> غیر ظریف
indicator -> نشانگر
indigenous -> بومی
indiscreet -> بی احتیاط
indulgence -> زیاده خواهی
inedible -> غیر قابل خوردن
inept -> بی منطق
inexpedient -> نامناسب
inexperienced -> بی تجربه
inexplicable -> غیر قابل توضیح
inextricable -> غیر قابل انکار
infertile -> نابارور
inflammable -> قابل اشتعال
infractructure -> زیرساخت
inhibit -> مهار کند
inhospitable -> غیر مهمان نواز
inset -> درونی
intrusive -> سرزده
invoke -> استناد کردن
invulnerable -> آسیب ناپذیر
irradiate -> تابش کند
irritable -> تحریک پذیر
jaguar -> جگوار
jangle -> جنجال
jargon -> اصطلاحات تخصصی
jaunty -> شادی آور
jobless -> بیکار
joggle -> دویدن
joyful -> شادی آور
juxtapose -> در کنار هم قرار دادن
juxtaposition -> کنار هم قرار دادن
kerb -> محدود کردن
keyhole -> سوراخ کلید
keynote -> سخنرانی کلیدی
knead -> ورز دادن
lacerate -> پارگی
lacy -> توری
lagoon -> مرداب
lanentable -> قابل غرق شدن
lamppost -> تیر چراغ برق
lamp-shade -> لامپ سایه
lance -> نیزه
landfall -> سقوط به خشکی
landmark -> نقطه عطف
languid -> سست
lank -> لنک
lardy -> خانم
lascivious -> هوسباز
lassitude -> سستی
latent -> نهفته
lavishness -> تجملات
lax -> سست
laxative -> ملین
leap year -> سال کبیسه
leaseholder -> دارنده اجاره
legalize -> قانونی کردن
leggy -> ساق پا
lenient -> ملایم
levity -> ساده لوحی
libellous -> افترا آمیز
likeable -> دوست داشتنی
likelihood -> احتمال
limelight -> کانون توجه
limitless -> بی حد و حصر
lineal -> خطی
linear -> خطی
lioness -> شیر ماده
liquidate -> انحلال
lisp -> لیسپ
listless -> بی حال
literacy -> سواد
lithe -> نرم
livestock -> دام
locus -> منبع
lollipop -> آب نبات چوبی
loom -> بافندگی
loot -> غارت کردن
lozenge -> پاستیل
lucent -> شفاف
lucidity -> شفافیت
lackless -> فاقد
lucrative -> سودآور
lumpy -> توده ای
magnanimity -> بزرگواری
majestic -> با شکوه
malicious -> مخرب
marshy -> باتلاقی
mediocre -> متوسط
mercenary -> مزدور
mermaid -> پری دریایی
merriment -> شادی
mesh -> مش
mesmerize -> مسحور کردن
middle-aged -> میانسال
midland -> میدلند
midsummer -> نیمه تابستان
midwife -> ماما
migration -> مهاجرت
migrant -> مهاجر
mildness -> ملایمت
mileage -> مسافت پیموده شده
milestone -> نقطه عطف
minder -> متذکر
minefield -> میدان مین
misfire -> شلیک نادرست
misfortune -> بد شانسی
mishandle -> سوء مدیریت
mislead -> گمراه کردن
misspell -> غلط املایی
mole -> خال
mussel -> صدف
muteness -> لال بودن
mutinous -> شورشی
nameless -> بی نام
namely -> برای مثال
namesake -> همنام
naval -> نیروی دریایی
navel -> ناف
navigate -> حرکت کنید
nebulous -> سحابی
needful -> مورد نیاز
negate -> نفی کردن
negation -> نفی
negligence -> غفلت
negligent -> سهل انگاری
neighbourly -> همسایه
nestle -> لانه سازی
neutrality -> بی طرفی
nightfall -> شب
nightingale -> بلبل
noiseless -> بی صدا
nomad -> عشایر
nonchalance -> بی اعتنایی
nonpareil -> بدون جبران
nosebleed -> خونریزی بینی
notability -> قابل توجه بودن
notary -> دفتر اسناد رسمی
notoriety -> بدنامی
nudge -> تکان دادن
nurture -> پرورش دادن
nutmeg -> جوز هندی
nutrient -> ماده مغذی
obdurate -> سرسخت
obedience -> اطاعت
objectless -> بی شی
obliterate -> محو کردن
obscenity -> فحاشی
observance -> رعایت
obsess -> وسواس داشتن
obstinate -> لجباز
obtrusive -> مزاحم
occult -> غیبی
occupant -> ساکن
occurrence -> وقوع
octopus -> اختاپوس
offender -> مجرم
offset -> انحراف
ominous -> شوم
omnipotent -> قادر مطلق
omnipresent -> همه جا حاضر
oncoming -> پیش رو
onefold -> یک برابر
onerous -> طاقت فرسا
open-air -> در فضای باز
open-minded -> روشنفکر
opinionated -> صاحب نظر
oppression -> ظلم
orb -> گوی
ostensible -> ظاهری
outbalance -> عدم تعادل
outbid -> پیشی گرفتن
outbreak -> شیوع
outburst -> انفجار
outlay -> هزینه
outmatch -> همسانی
outnumber -> از تعداد
outright -> کاملا
outset -> ابتدا
outskirts -> حومه
overjoyed -> بسیار خوشحال
overlap -> همپوشانی
overlive -> بیش از حد زنده ماندن
oversleep -> بیش از حد خوابیدن
overweight -> اضافه وزن
oxide -> اکسید
pacify -> آرام کردن
palette -> جعبه رنگ نقاشی
pallor -> رنگ پریدگی
palmful -> کف دست
palpable -> قابل لمس
palpate -> لمس کردن
palsy -> فلج
pancreas -> پانکراس
parable -> تمثیل
parity -> برابری
parquet -> پارکت
parting -> فراق
passable -> قابل عبور
paternal -> پدری
patronage -> حمایت
pavilion -> غرفه
peachy -> هلویی
pectoral -> سینه ای
peculiarity -> خصوصیات عجیب و غریب
peephole -> روزنه چشمی
peerless -> بی همتا
peevish -> بداخلاق
pelt -> پوست انداختن
pendulous -> آویزان
penitence -> توبه
penitent -> پشیمان
penniless -> بی پول
pensioner -> مستمری بگیر
peppery -> فلفلی
percussive -> ضربی
peremptory -> بی چون و چرا
perennial -> چند ساله
perfunctory -> سرسری
periodic -> تناوبی
permissive -> سهل گیر
perpetrate -> مرتکب شدن
perpetrator -> مرتکب
persevere -> استقامت کن
personify -> شخصیت کردن
perspiration -> تعریق
perspire -> عرق کردن
pert -> پرت
peruse -> مطالعه کنید
pervasive -> فراگیر
pester -> مزاحم
pestilent -> آفت زا
petulant -> متعصب
picturesque -> زیبا
pictorial -> تصویری
piercing -> سوراخ کردن
piety -> تقوا
pillar -> ستون
pillowcase -> روبالشی
pilotage -> خلبانی
pine cone -> مخروط کاج
pinprick -> سنجاق
placidity -> آرامش
plash -> پلش
platitude -> بی ادبی
plenitude -> فراوانی
pliant -> انعطاف پذیر
plumb -> شاقول
plume -> ستون
plump -> چاق
poignant -> تکان دهنده
polity -> سیاست
pollen -> گرده
pomegranate -> انار
pomp -> شکوه
pomposity -> شکوهمندی
ponderous -> سنگین
populate -> پر جمعیت کردن
portent -> نشانه
portly -> پر سر و صدا
portray -> تصویر کشیدن
posh -> شیک
possible -> ممکن است
postal -> پستی
posture -> وضعیت بدن
potency -> قدرت
prawn -> میگو
precursor -> پیش ساز
predestination -> جبر
predestine -> مقدر کردن
premonition -> پیشگویی
prepay -> پیش پرداخت
prepense -> آماده کردن
prevalent -> رایج است
prevention -> جلوگیری
prickly -> خاردار
primeval -> اولیه
proclamation -> اعلامیه
prod -> تولید
prodigal -> ولخرج
prodigious -> شگفت انگیز
profane -> ناسزا
profanity -> فحاشی
profess -> حرفه ای
progeny -> نتاج
prohibition -> ممنوعیت
projection -> طرح ریزی
prosperity -> رفاه
provisional -> موقت
prowess -> توانمندی
prowl -> پرسه زدن
prudent -> محتاط، معقول
puncture -> پنچر شدن
purge -> پاکسازی
purify -> خالص - تصفیه
pushful -> پر فشار
putrefy -> گندیده
putrescent -> پوسیده
puzzlement -> گیج شدن
quake -> زلزله
quaking -> لرزش
quandary -> معضل
quarrelsome -> دعوا
quasi -> شبه
quell -> فرو ریختن
quench -> فرو نشاندن
rabid -> هار
radiant -> تابناک
rancid -> فاسد
rancorous -> کینه توز
rant -> بیهوده گویی
rapacity -> درنده خویی
rapt -> تسخیر کردن
rarity -> نادر بودن
rasp -> سوهان
ravenous -> بسیار گرسنه
rebellion -> شورش
recant -> انصراف دادن
recast -> بازنویسی
recede -> عقب نشینی کند
reseptive -> گیرنده
recipient -> گیرنده
reciprocal -> متقابل
recite -> از بر خواندن
rectification -> اصلاح
recuperate -> بهبود یافتن
recurrent -> عود کننده
redden -> قرمز شدن
redress -> جبران خسارت
reek -> بو کردن
referee -> داور
refrigerate -> در یخچال قرار دهید
regretful -> پشیمان
regrettable -> تاسف آور
reliance -> تکیه
reliant -> متکی
relish -> لذت بردن
remembrance -> یادآوری
remiss -> از قلم انداختن
renaissance -> رنسانس
renewal -> بازسازی
repellent -> دافع
replica -> المثنی، کپی دقیق
repose -> آرام گرفتن
reprehensible -> سزاوار سرزنش
reprove -> سرزنش کردن
repute -> شهرت
resemble -> شبیه
resentful -> دلخور
resedue -> پسماند
reverence -> احترام
revert -> برگرداندن
revoke -> لغو
revolve -> بچرخد
revulsion -> تنفر شدید
rigour -> سخت گیری
riotous -> آشوب زده
rotund -> گرد
roundabout -> میدان
rucksack -> کوله پشتی
rudimentary -> ابتدایی
ruinous -> ویرانگر
ruse -> نیرنگ
abc.xyz -> abc.xyz
n't -> نه
yeah -> بله
oh -> اوه
american -> آمریکایی
hey -> سلام
including -> شامل
true -> درست
thanks -> با تشکر
realize -> پی بردن
color -> رنگ
uh -> اوه
throw -> پرت كردن
behavior -> رفتار - اخلاق
ok -> خوب
tv -> تلویزیون
hi -> سلام
supposed -> فرض می شود
did -> انجام داد
don't -> نکن
got -> بدست آورد
began -> آغاز شد
heard -> شنیده شد
done -> انجام شده
stood -> ایستاد
stead -> به جای
equate -> برابر کردن
brought -> آورده شده
am -> صبح
felt -> نمد
written -> نوشته شده است
kept -> نگهداری می شود
gone -> رفته
atom -> اتم
won't -> نمی خواهد
neighbor -> همسایه
quart -> کوارت
suffix -> پسوند
bought -> خرید
led -> رهبری
favor -> لطف
chick -> جوجه
meant -> منظور
quotient -> ضریب
activist -> فعال
ad -> آگهی
administrator -> مدیر
adviser -> مشاور
african -> آفریقایی
african-american -> آفریقایی آمریکایی
ah -> آه
aide -> مشاور
analyst -> تحلیلگر
asian -> آسیایی
assess -> ارزیابی کنید
attach -> ضمیمه کردن
bombing -> بمب گذاری
can't -> نمی تواند
ceo -> مدیر عامل
cholesterol -> کلسترول
cite -> نقل قول
closer -> نزدیک تر
clothes -> لباس ها
cognitive -> شناختی
competitor -> رقیب
complicated -> بغرنج
concerned -> نگران
congressional -> کنگره
cop -> پلیس
correspondent -> خبرنگار
counselor -> مشاور
cried -> گریه کرد
criteria -> شاخص
decided -> تصمیم گرفت
depending -> بسته به
devote -> اختصاص
didn't -> نکرد
distribute -> توزیع کردن
dramatically -> به طور چشمگیری
e-mail -> پست الکترونیک
economist -> اقتصاددان
educator -> مربی
effectively -> به طور موثر
emission -> انتشار
ethics -> اخلاق
european -> اروپایی
false -> غلط
favorite -> مورد علاقه
fiber -> فیبر
fighting -> زد و خورد
flavor -> طعم و مزه
founder -> موسس
generate -> تولید می کنند
guideline -> راهنمای
happened -> اتفاق افتاد
headquarters -> مرکز فرماندهی
honor -> افتخار و احترام
humor -> شوخ طبعی
hunting -> شکار
ie -> یعنی
increased -> افزایش یافت
increasing -> افزایش می یابد
indian -> هندی
institutional -> سازمانی
intensity -> شدت
interaction -> اثر متقابل
involved -> گرفتار
iraqi -> عراقی
irish -> ایرلندی
islamic -> اسلامی
israeli -> اسرائیلی
judgment -> داوری
killing -> کشتن
labor -> کار یدی
latin -> لاتین
learning -> یادگیری
long-term -> دراز مدت
manufacturing -> تولید
mexican -> مکزیکی
mr -> آقای
mrs -> خانم
ms -> خانم
muslim -> مسلمان
neighborhood -> محله
nomination -> نامزدی
olympic -> المپیک
operating -> عملیاتی
others -> دیگران
palestinian -> فلسطینی
passed -> گذشت
pc -> کامپیوتر
pm -> بعد از ظهر
proposed -> پیشنهاد شده
provider -> ارائه دهنده
psychologist -> روانشناس
quantifier -> کمیت کننده
recording -> ضبط کردن
refugee -> پناهنده
regarding -> با توجه
regulate -> تنظیم کند
researcher -> محقق
respondent -> پاسخ دهنده
sales -> حراجی
sanction -> تحریم
scared -> ترسیده
senator -> سناتور
setting -> تنظیمات
shooting -> تیراندازی کردن
somewhere -> جایی
soviet -> شوروی
spending -> خرج کردن
standing -> ایستاده
surprised -> غافلگیر شدن
tablespoon -> قاشق سوپخوری
teaching -> درس دادن
testing -> آزمایش کردن
theater -> تئاتر
undergo -> تحت
voter -> رای دهنده
vs -> در مقابل
willing -> مایل بودن
words -> کلمات
working -> کار کردن
works -> آثار
worried -> نگران
zebra -> گورخر