A1
--
a  ->  آ
about  ->  در باره
above  ->  در بالا
address  ->  نشانی
adult  ->  بالغ
after  ->  بعد از
afternoon  ->  بعد از ظهر
again  ->  از نو
age  ->  سن
all  ->  همه
all right  ->  خیلی خوب
alright  ->  بسیار خوب
also  ->  همچنین
always  ->  همیشه
a.m. (am)  ->  هستم (ام)
an  ->  یک
and  ->  و
animal  ->  حیوان
answer  ->  پاسخ
any  ->  هر
anything  ->  هر چیزی
apple  ->  سیب
april  ->  آوریل
arm  ->  بازو
as  ->  مانند
ask  ->  پرسیدن
at  ->  در
august  ->  اوت
baby  ->  عزیزم
back  ->  بازگشت
bad  ->  بد
bag  ->  کیسه
ball  ->  توپ
banana  ->  موز
band  ->  باند
bank  ->  بانک
bar  ->  بار
basketball  ->  بسکتبال
bath  ->  حمام
bathroom  ->  حمام
be  ->  بودن
beach  ->  ساحل دریا
beard  ->  ریش
beautiful  ->  زیبا
because  ->  زیرا
bed  ->  بستر
bedroom  ->  اتاق خواب
beer  ->  آبجو
before  ->  قبل از
begin  ->  شروع
behind  ->  پشت
below  ->  زیر
best  ->  بهترین
better  ->  بهتر
between  ->  بین
big  ->  بزرگ
bird  ->  پرنده
birthday  ->  روز تولد
biscuit  ->  بیسکویت
black  ->  سیاه
blue  ->  آبی
board  ->  هیئت مدیره
boat  ->  قایق
body  ->  بدن
book  ->  کتاب
bored  ->  خسته
boring  ->  حوصله سر بر
both  ->  هر دو
bottom  ->  پایین
box  ->  جعبه
boy  ->  پسر
bread  ->  نان
breakfast  ->  صبحانه
brother  ->  برادر
brown  ->  رنگ قهوه ای
bus  ->  اتوبوس
business  ->  کسب و کار
but  ->  ولی
butter  ->  کره
buy  ->  خرید
bye  ->  خدا حافظ
café (also cafe)  ->  کافه (همچنین کافه)
cake  ->  کیک
call  ->  زنگ زدن
camera  ->  دوربین
can2  ->  can2
cannot  ->  نمی تواند
car  ->  ماشین
carry  ->  حمل
cat  ->  گربه
catch  ->  گرفتن
cd  ->  سی دی
cd player  ->  سی دی پلیر
chair  ->  صندلی
change  ->  تغییر دادن
cheap  ->  ارزان
cheese  ->  پنیر
child  ->  کودک
chip  ->  تراشه
chocolate  ->  شکلات
choose  ->  انتخاب کنید
cinema  ->  سینما
city  ->  شهر
class  ->  کلاس
classroom  ->  کلاس درس
clean  ->  تمیز
clever  ->  باهوش
clock  ->  ساعت
verb  ->  فعل
adjective  ->  صفت
closed  ->  بسته
clothes  ->  لباس ها
coat  ->  کت
coffee  ->  قهوه
cold  ->  سرد
colour  ->  رنگ
come  ->  بیا
computer  ->  کامپیوتر
conversation  ->  گفتگو
cook  ->  پختن
country  ->  کشور
course  ->  دوره
cow  ->  گاو
credit card  ->  کارت اعتباری
cross  ->  صلیب
cup  ->  فنجان
dance  ->  رقصیدن
dancing  ->  رقصیدن
dark  ->  تاریک
date  ->  تاریخ
daughter  ->  فرزند دختر
day  ->  روز
dear  ->  عزیز
december  ->  دسامبر
desk  ->  میز کار
dictionary  ->  فرهنگ لغت
die  ->  بمیر
different  ->  ناهمسان
difficult  ->  دشوار
dining room  ->  ناهارخوری
dinner  ->  شام
do  ->  انجام دادن
doctor  ->  دکتر
dog  ->  سگ
doll  ->  عروسک
dollar  ->  دلار
door  ->  در، درب
down  ->  پایین
draw  ->  قرعه کشی
dress  ->  لباس
drink  ->  نوشیدنی
drive  ->  راندن
driver  ->  راننده
dvd  ->  دی وی دی
each  ->  هر یک
ear  ->  گوش
early  ->  زود
easy  ->  آسان
eat  ->  خوردن
egg  ->  تخم مرغ
eight  ->  هشت
eighteen  ->  هجده
eleven  ->  یازده
email (also e-mail)  ->  ایمیل (همچنین ایمیل)
end  ->  پایان
enjoy  ->  لذت ببرید
evening  ->  عصر
every  ->  هر
example  ->  مثال
excited  ->  برانگیخته
exciting  ->  هیجان انگیز
expensive  ->  گران
eye  ->  چشم
face  ->  صورت
factory  ->  کارخانه
family  ->  خانواده
famous  ->  معروف
farm  ->  مزرعه
fast  ->  سریع
fat  ->  چربی
father  ->  پدر
favourite  ->  مورد علاقه
february  ->  فوریه
feel  ->  احساس کنید
fifteen  ->  پانزده
film  ->  فیلم
find  ->  پیدا کردن
fine  ->  خوب
finish  ->  تمام کردن
first  ->  اولین
fish  ->  ماهی
five  ->  پنج
flat  ->  تخت
floor  ->  کف
flower  ->  گل
fly  ->  پرواز
food  ->  غذا
foot  ->  پا
football  ->  فوتبال
for  ->  برای
forget  ->  فراموش کردن
four  ->  چهار
fourteen  ->  چهارده
friday  ->  جمعه
friend  ->  دوست
from  ->  از جانب
fruit  ->  میوه
fun  ->  سرگرم کننده
funny  ->  خنده دار
game  ->  بازی
garden  ->  باغ
get  ->  گرفتن
girl  ->  دختر
give  ->  دادن
glass  ->  شیشه
glasses  ->  عینک
go  ->  برو
good  ->  خوب
good afternoon  ->  عصر بخیر
goodbye  ->  خداحافظ
good evening  ->  عصر بخیر
good morning  ->  صبح بخیر
good night  ->  شب بخیر
grass  ->  چمن
great  ->  عالی
green  ->  سبز
grey  ->  خاکستری
group  ->  گروه
guitar  ->  گیتار
hair  ->  مو
half  ->  نیم
hand  ->  دست
happy  ->  خوشحال
hard  ->  سخت
hat  ->  کلاه
have  ->  دارند
he  ->  او
head  ->  سر
hear  ->  شنیدن
hello  ->  سلام
help  ->  کمک
her  ->  او
here  ->  اینجا
hi  ->  سلام
him  ->  به او
his  ->  خود
holiday  ->  تعطیلات
home  ->  خانه
homework  ->  مشق شب
horse  ->  اسب
hospital  ->  بیمارستان
hot  ->  داغ
hotel  ->  هتل
hour  ->  ساعت
noun  ->  اسم
how  ->  چگونه
hungry  ->  گرسنه
husband  ->  شوهر
i  ->  من
ice cream  ->  بستنی
important  ->  مهم
in  ->  که در
preposition  ->  حرف اضافه
interesting  ->  جالب هست
into  ->  به
invite  ->  دعوت
it  ->  آی تی
its  ->  آن
jacket  ->  ژاکت
january  ->  ژانویه
jeans  ->  شلوار جین
job  ->  کار
juice  ->  آب میوه
july  ->  جولای
june  ->  ژوئن
key  ->  کلید
kick  ->  لگد زدن
kind  ->  نوع
kitchen  ->  آشپزخانه
knife  ->  چاقو
know  ->  دانستن
language  ->  زبان
last  ->  آخر
late  ->  دیر
later  ->  بعد
learn  ->  فرا گرفتن
leave  ->  ترک کردن
leg  ->  پا
lesson  ->  درس
letter  ->  حرف
life  ->  زندگی
light  ->  سبک
like  ->  پسندیدن
listen  ->  گوش کنید
little  ->  مقدار کمی
living room  ->  هال
long  ->  طولانی
look  ->  نگاه کن
lot  ->  مقدار زیادی
love  ->  عشق
lunch  ->  ناهار
make  ->  ساختن
man  ->  مرد
many  ->  زیاد
march  ->  مارس
may  ->  ممکن است
me  ->  من
meal  ->  وعده غذایی
meat  ->  گوشت
meet  ->  ملاقات
message  ->  پیام
milk  ->  شیر
minute  ->  دقیقه
miss  ->  از دست دادن
mobile  ->  سیار
mobile phone  ->  تلفن همراه
monday  ->  دوشنبه
money  ->  پول
month  ->  ماه
more  ->  بیشتر
morning  ->  صبح
mother  ->  مادر
mouth  ->  دهان
movie  ->  فیلم سینما
mr  ->  آقای
mrs  ->  خانم
much  ->  بسیار
mum  ->  مامان
museum  ->  موزه
music  ->  موسیقی
my  ->  من
name  ->  نام
nationality  ->  ملیت
near  ->  نزدیک
need  ->  نیاز داشتن
never  ->  هرگز
new  ->  جدید
newspaper  ->  روزنامه
next  ->  بعد
nice  ->  خوب
night  ->  شب
nine  ->  نه
nineteen  ->  نوزده
no  ->  نه
noise  ->  سر و صدا
nose  ->  بینی
not  ->  نه
note  ->  توجه داشته باشید
november  ->  نوامبر
now  ->  اکنون
number  ->  عدد
o'clock  ->  ساعت
october  ->  اکتبر
of  ->  از
often  ->  غالبا
oh  ->  اوه
ok (also okay)  ->  باشه (همچنین خوبه)
old  ->  قدیمی
on  ->  بر
one  ->  یکی
only  ->  فقط
open  ->  باز کن
or  ->  یا
orange  ->  نارنجی
other  ->  دیگر
our  ->  ما
adverb  ->  قید
page  ->  صفحه
paint  ->  رنگ کردن
pair  ->  جفت
paper  ->  کاغذ
parent  ->  والدین
park  ->  پارک
part  ->  بخش
party  ->  مهمانی - جشن
past  ->  گذشته
pay  ->  پرداخت
pen  ->  خودکار
pencil  ->  مداد
people  ->  مردم
person  ->  شخص
pet  ->  حیوان خانگی
phone  ->  تلفن
photo  ->  عکس
picnic  ->  پیک نیک
picture  ->  تصویر
pig  ->  خوک
pizza  ->  پیتزا
place  ->  محل
plane  ->  سطح
plant  ->  گیاه
plate  ->  بشقاب
play  ->  بازی
player  ->  بازیکن
please  ->  لطفا
p.m. (also pm)  ->  بعد از ظهر (همچنین بعد از ظهر)
poor  ->  فقیر
possible  ->  ممکن است
potato  ->  سیب زمینی
practise  ->  تمرین
problem  ->  مسئله
put  ->  قرار دادن
quarter  ->  ربع
question  ->  سوال
quick  ->  سریع
radio  ->  رادیو
rain  ->  باران
read  ->  خواندن
reading  ->  خواندن
ready  ->  آماده
really  ->  واقعا
red  ->  قرمز
remember  ->  یاد آوردن
restaurant  ->  رستوران
rice  ->  برنج
ride  ->  سوار شدن
right  ->  درست
river  ->  رودخانه
road  ->  جاده
room  ->  اتاق
run  ->  اجرا کن
sad  ->  غمگین
safe  ->  بی خطر
salt  ->  نمک
same  ->  یکسان
sandwich  ->  ساندویچ
saturday  ->  شنبه
say  ->  گفتن
school  ->  مدرسه
sea  ->  دریا
second  ->  دومین
see  ->  دیدن
send  ->  ارسال
sentence  ->  جمله
september  ->  سپتامبر
seven  ->  هفت
seventeen  ->  هفده
she  ->  او
sheep  ->  گوسفند
shirt  ->  پیراهن
shoe  ->  کفش
shop  ->  فروشگاه
shopping  ->  خريد كردن
short  ->  کوتاه
show  ->  نشان می دهد
shower  ->  دوش
sing  ->  آواز خواندن
sister  ->  خواهر
sit  ->  بنشین
six  ->  شش
sixteen  ->  شانزده
skirt  ->  دامن
sleep  ->  خواب
slim  ->  باریک
slow  ->  آهسته. تدریجی
small  ->  کم اهمیت
smoke  ->  دود
smoking  ->  سیگار کشیدن
snow  ->  برف
some  ->  مقداری
something  ->  چیزی
sometimes  ->  گاهی
son  ->  فرزند پسر
soon  ->  به زودی
sorry  ->  متاسف
soup  ->  سوپ
speak  ->  صحبت
sport  ->  ورزش
start  ->  شروع کنید
station  ->  ایستگاه
stay  ->  ماندن
stop  ->  متوقف کردن
street  ->  خیابان
student  ->  دانشجو
study  ->  مطالعه
sugar  ->  قند
summer  ->  تابستان
sun  ->  آفتاب
sunday  ->  یکشنبه
supermarket  ->  سوپر مارکت
sweet  ->  شیرین
swim  ->  شنا کردن
swimming pool  ->  استخر
table  ->  جدول
take  ->  گرفتن
talk  ->  صحبت
tall  ->  بلند قد
taxi  ->  تاکسی
tea  ->  چای
teach  ->  آموزش دهید
teacher  ->  معلم
television  ->  تلویزیون
tell  ->  بگو
ten  ->  ده
tennis  ->  تنیس
test  ->  تست
than  ->  نسبت به. تا
thanks  ->  با تشکر
thank you  ->  متشکرم
that  ->  که
the  ->  را
the internet (also the net)  ->  اینترنت (همچنین شبکه)
their  ->  آنها
them  ->  آنها
then  ->  سپس
there  ->  آنجا
these  ->  اینها
they  ->  آنها
thing  ->  چیز
think  ->  فکر
thirteen  ->  سیزده
this  ->  این
those  ->  آن ها
three  ->  سه
thursday  ->  پنج شنبه
ticket  ->  بلیط
time  ->  زمان
tired  ->  خسته
to  ->  به
today  ->  امروز
together  ->  با یکدیگر
toilet  ->  توالت
tomato  ->  گوجه فرنگی
tomorrow  ->  فردا
tonight  ->  امشب
too  ->  هم
tooth  ->  دندان
town  ->  شهر
train  ->  قطار - تعلیم دادن
travel  ->  مسافرت رفتن
tree  ->  درخت
trousers  ->  شلوار
t-shirt  ->  تی شرت
tuesday  ->  سهشنبه
tv  ->  تلویزیون
twelve  ->  دوازده
twenty  ->  بیست
two  ->  دو
under  ->  زیر
understand  ->  فهمیدن
university  ->  دانشگاه
until  ->  تا زمان
up  ->  بالا
us  ->  ما
vegetable  ->  سبزی
very  ->  بسیار
village  ->  دهکده
visit  ->  بازدید کنید
wait  ->  صبر کن
waiter  ->  گارسون
waitress  ->  پیشخدمت
wake  ->  از خواب بیدار
walk  ->  راه رفتن
wall  ->  دیوار
want  ->  خواستن
warm  ->  گرم
wash  ->  شستشو
watch  ->  تماشا کردن
water  ->  اب
we  ->  ما
wear  ->  پوشیدن
weather  ->  آب و هوا
website (also web site)  ->  وب سایت (همچنین وب سایت)
wednesday  ->  چهار شنبه
week  ->  هفته
weekend  ->  تعطیلات آخر هفته
well  ->  خوب
what  ->  چی
when  ->  چه زمانی
where  ->  جایی که
which  ->  که
white  ->  سفید
who  ->  سازمان بهداشت جهانی
why  ->  چرا
wife  ->  همسر
will  ->  اراده
wind1  ->  باد 1
window  ->  پنجره
wine  ->  شراب
winter  ->  زمستان
with  ->  با
woman  ->  زن
word  ->  کلمه
work  ->  کار کردن
world  ->  جهان
worry  ->  نگران بودن
would  ->  خواهد شد
write  ->  نوشتن
writing  ->  نوشتن
wrong  ->  اشتباه
year  ->  سال
yellow  ->  رنگ زرد
yes  ->  آره
yesterday  ->  دیروز
you  ->  شما
young  ->  جوان
your  ->  شما
zoo  ->  باغ وحش

A2
--
able  ->  قادر است
accident  ->  تصادف
across  ->  در سراسر
activity  ->  فعالیت
actor  ->  بازیگر
actually  ->  در حقیقت
add  ->  اضافه کردن
advanced  ->  پیشرفته
adventure  ->  ماجرا
advertisement  ->  تبلیغات
advice  ->  مشاوره
aeroplane  ->  هواپیما
afraid  ->  می ترسد
afterwards  ->  پس از آن
against  ->  در برابر
aged  ->  سن
ago  ->  پیش
agree  ->  موافق
air  ->  هوا
airport  ->  فرودگاه
alarm clock  ->  ساعت زنگدار
album  ->  آلبوم
alcohol  ->  الکل
almost  ->  تقریبا
alone  ->  تنها
along  ->  در امتداد
already  ->  قبلا، پیش از این
amazing  ->  شگفت انگيز
ambulance  ->  آمبولانس
among  ->  در میان
angry  ->  خشمگین
another  ->  یکی دیگر
anybody  ->  هر شخصی
anymore  ->  دیگر
anyone  ->  هر کسی
anyway  ->  به هر حال
anywhere  ->  هر جا
apartment  ->  اپارتمان
appointment  ->  وقت ملاقات
area  ->  حوزه
armchair  ->  صندلی راحتی
around  ->  دور و بر
arrive  ->  رسیدن
art  ->  هنر
artist  ->  هنرمند
assistant  ->  دستیار
attractive  ->  جذاب
aunt  ->  عمه
autumn  ->  فصل پاييز
available  ->  در دسترس
away  ->  دور
awesome  ->  عالی
badly  ->  بد
badminton  ->  بدمینتون
bake  ->  پختن
balloon  ->  بالون
barbecue  ->  باربیکیو
baseball  ->  بیسبال
bat  ->  خفاش
battery  ->  باتری
bean  ->  لوبیا
bear  ->  خرس
become  ->  تبدیل شود
beginner  ->  مبتدی
beginning  ->  شروع
believe  ->  ایمان داشتن
belong  ->  تعلق داشتن
belt  ->  کمربند
beside  ->  در كنار
bicycle  ->  دوچرخه
bike  ->  دوچرخه
bill  ->  صورت حساب
biology  ->  زیست شناسی
bit  ->  بیت
blackboard  ->  تخته سیاه
blanket  ->  پتو
blonde (also blond)  ->  بلوند (همچنین بلوند)
blood  ->  خون
board game  ->  بازی تخته
boil  ->  جوشیدن
boiled  ->  آب پز شده
bookcase  ->  قفسه کتاب
bookshelf  ->  قفسه کتاب
bookshop  ->  کتابفروشی
boot  ->  چکمه
born  ->  بدنیا آمدن
borrow  ->  امانت گرفتن
boss  ->  رئیس
bother  ->  زحمت
bottle  ->  بطری
bowl  ->  کاسه
boyfriend  ->  دوست پسر
brain  ->  مغز
break  ->  زنگ تفريح
bridge  ->  پل
bright  ->  روشن
brilliant  ->  درخشان
bring  ->  آوردن
broken  ->  شکسته شده
brush  ->  قلم مو
build  ->  ساختن
building  ->  ساختمان
burger  ->  برگر
businessman  ->  تاجر
businesswoman  ->  زن تاجر
bus station  ->  ایستگاه اتوبوس
bus stop  ->  ایستگاه اتوبوس
busy  ->  مشغول
by  ->  توسط
calendar  ->  تقویم
camp  ->  اردوگاه
camping  ->  چادر زدن
can1  ->  قوطی 1
cap  ->  کلاه لبه دار
capital  ->  سرمایه، پایتخت
capital letter  ->  حرف بزرگ
card  ->  کارت
care  ->  مراقبت
careful  ->  مراقب باشید
carefully  ->  با دقت
car park  ->  پارکینگ ماشین
carpet  ->  فرش
carrot  ->  هویج
cartoon  ->  کارتون
case  ->  مورد
cash  ->  پول نقد
castle  ->  قلعه
cathedral  ->  کلیسای جامع
ceiling  ->  سقف
cent  ->  سنت
centimetre  ->  سانتی متر
centre  ->  مرکز
cereal  ->  غلات
certainly  ->  قطعا
chain  ->  زنجیر
champagne  ->  شامپاین
channel  ->  کانال
chat  ->  چت کردن
check  ->  بررسی
chef  ->  سرآشپز
chemist  ->  شیمیدان
chemistry  ->  علم شیمی
cheque  ->  بررسی
chess  ->  شطرنج
chicken  ->  مرغ
chilli  ->  تند
church  ->  کلیسا
cigarette  ->  سیگار
circle  ->  دایره
classical  ->  کلاسیک
classmate  ->  همکلاسی
cleaner  ->  پاک کننده
clear  ->  روشن
clearly  ->  به وضوح
click  ->  کلیک
climb  ->  بالا رفتن
climbing  ->  سنگ نوردی
cloud  ->  ابر
cloudy  ->  ابری
clown  ->  دلقک
club  ->  باشگاه
coach  ->  مربی
cola  ->  کولا
colleague  ->  همکار
collect  ->  جمع آوری کنید
college  ->  دانشکده
comb  ->  شانه کردن
comfortable  ->  راحت
comic  ->  کمیک
company  ->  شرکت
comparative  ->  مقایسه ای
competition  ->  رقابت
complete  ->  کامل
concert  ->  کنسرت
congratulations  ->  تبریک می گویم
contact  ->  مخاطب
cooker  ->  اجاق گاز
cooking  ->  پخت و پز
cool  ->  سرد
copy  ->  کپی 🀄
corner  ->  گوشه
correct  ->  درست
cost  ->  هزینه
could  ->  میتوانست
countryside  ->  حومه شهر
cousin  ->  عمو زاده
cover  ->  پوشش دادن
crazy  ->  دیوانه
cream  ->  کرم رنگ
cricket  ->  کریکت
crisp  ->  ترد
crowd  ->  جمعیت
crowded  ->  شلوغ
cry  ->  گریه کردن
cupboard  ->  کابینت
curry  ->  ادویه کاری
curtain  ->  پرده
customer  ->  مشتری
cut  ->  قطع كردن
cycling  ->  دوچرخه سواري
daily  ->  روزانه
dancer  ->  رقصنده
danger  ->  خطر
dangerous  ->  خطرناک
dead  ->  مرده
decide  ->  تصميم گرفتن
deep  ->  عمیق
degree  ->  درجه
delay  ->  تاخیر انداختن
dentist  ->  دندانپزشک
department  ->  بخش
department store  ->  فروشگاه بزرگ
describe  ->  توصیف کردن
desert  ->  کویر
dessert  ->  دسر
detail  ->  جزئیات
diary  ->  دفتر خاطرات
difference  ->  تفاوت
digital  ->  دیجیتال
digital camera  ->  دوربین دیجیتال
dinosaur  ->  دایناسور
diploma  ->  دیپلم
directions  ->  جهت ها
dirty  ->  کثیف
disco  ->  دیسکو
discount  ->  تخفیف
discuss  ->  بحث و گفتگو
dish  ->  ظرف
document  ->  سند
double  ->  دو برابر
dr  ->  دکتر
drawer  ->  کشو
drawing  ->  طراحی
dream  ->  رویا
dressed  ->  لباس پوشیده
driving licence  ->  گواهینامه رانندگی
drum  ->  طبل
dry  ->  خشک
duck  ->  اردک
during  ->  در حین
earn  ->  بدست آوردن
earring  ->  گوشواره
easily  ->  به آسانی
east (also east)  ->  شرق (همچنین شرق)
eighth  ->  هشتم
eighty  ->  هشتاد
electric  ->  برقی
electricity  ->  برق
elephant  ->  فیل
else  ->  دیگر
empty  ->  خالی
engine  ->  موتور
engineer  ->  مهندس
enough  ->  کافی
enter  ->  وارد
entrance  ->  ورود
envelope  ->  پاكت نامه
especially  ->  بخصوص
euro (also euro)  ->  یورو (همچنین یورو)
even  ->  زوج
ever  ->  همیشه
everybody  ->  همه
everyone  ->  هر کس
everything  ->  همه چيز
everywhere  ->  هر کجا
exactly  ->  دقیقا
exam  ->  امتحان
examination  ->  معاینه
excellent  ->  عالی
except  ->  بجز
exercise  ->  ورزش
exit  ->  خروج
explain  ->  توضیح
extra  ->  اضافی
fact  ->  حقیقت
fail  ->  مردود شدن
fair  ->  نمایشگاه
fall  ->  سقوط
fan  ->  پنکه
fantastic  ->  خارق العاده
far  ->  دور
farmer  ->  مزرعه دار
fashion  ->  روش
fast food  ->  فست فود
few  ->  تعداد کمی
field  ->  رشته
fifth  ->  پنجم
fifty  ->  پنجاه
file  ->  فایل
fill  ->  پر کردن
final  ->  نهایی
finally  ->  سرانجام
finger  ->  انگشت
fire  ->  آتش
first name  ->  نام کوچک
fishing  ->  صید ماهی
fit  ->  مناسب
flight  ->  پرواز
fog  ->  مه
foggy  ->  مه آلود
folder  ->  پوشه
follow  ->  دنبال کردن
footballer  ->  فوتبالیست
foreign  ->  خارجی
forest  ->  جنگل
fork  ->  چنگال
form  ->  فرم
forty  ->  چهل
fourth  ->  چهارم
free  ->  رایگان
fresh  ->  تازه
fridge  ->  یخچال
fried  ->  سرخ شده در روغن
friendly  ->  دوستانه
front  ->  جلو
full  ->  پر شده
furniture  ->  مبلمان
further  ->  به علاوه
future  ->  آینده
garage  ->  گاراژ
garlic  ->  سیر
gas  ->  گاز
gate  ->  دروازه
geography  ->  جغرافیا
gift  ->  هدیه
girlfriend  ->  دوست دختر
glad  ->  خوشحالم
glove  ->  دستکش
goal  ->  هدف
god  ->  خداوند
gold  ->  طلا
golden  ->  طلایی
golf  ->  گلف
good-looking  ->  خوش تیپ
gram (uk also gramme)  ->  گرم (انگلیسی همچنین گرم)
grammar  ->  دستور زبان
grandchild  ->  نوه
granddad (also grandad)  ->  پدربزرگ (همچنین پدربزرگ)
granddaughter  ->  نوه
grandfather  ->  بابا بزرگ
grandma  ->  مادر بزرگ
grandmother  ->  مادر بزرگ
grandpa  ->  پدربزرگ
grandparent  ->  پدربزرگ و مادربزرگ
grandson  ->  نوه پسر
granny  ->  مادربزرگ
grape  ->  انگور
grilled  ->  کباب شده
grow  ->  رشد
guess  ->  حدس بزن
guest  ->  مهمان
guide  ->  راهنما
guidebook  ->  کتاب راهنما
guy  ->  پسر
half-price  ->  نصف قیمت
hall  ->  سالن
ham  ->  ژامبون
handbag  ->  کیف دستی
happen  ->  گاز گرفتن
hate  ->  نفرت
headache  ->  سردرد
headteacher  ->  مدیر
health  ->  سلامتی
healthy  ->  سالم
heart  ->  قلب
heating  ->  گرمایش
heavy  ->  سنگین
helicopter  ->  بالگرد
hers  ->  مال او
herself  ->  خودش
hey  ->  سلام
high  ->  بالا
hill  ->  تپه
himself  ->  خودش
hip-hop  ->  هیپ هاپ
history  ->  تاریخ
hit  ->  اصابت
hobby  ->  سرگرمی
hockey  ->  هاکی
hold  ->  نگه دارید
honey  ->  عسل
hope  ->  امید
horrible  ->  ناگوار
housewife  ->  خانم خانه دار
however  ->  با این حال
hundred  ->  صد
hurry  ->  عجله کن
hurt  ->  صدمه
ice  ->  یخ
id  ->  شناسه
id card  ->  کارت شناسایی
idea  ->  اندیشه
identification  ->  شناسایی
if  ->  اگر
ill  ->  بیمار
immediately  ->  بلافاصله. مستقیما
improve  ->  بهتر کردن
include  ->  عبارتند از
including  ->  شامل
indoor  ->  داخلی
information  ->  اطلاعات
insect  ->  حشره
instead  ->  بجای
instruction  ->  دستورالعمل
instrument  ->  ابزار
interested  ->  علاقه مند
international  ->  بین المللی
invitation  ->  دعوت
island  ->  جزیره
itself  ->  خود
jam  ->  مربا
jazz  ->  جاز
jewellery  ->  جواهرات
join  ->  پیوستن
journey  ->  سفر
jump  ->  پرش
jumper  ->  جامپر
just  ->  فقط
keep  ->  نگاه داشتن
keyboard  ->  صفحه کلید
kid  ->  بچه
kill  ->  کشتن
kilo  ->  کیلو
kilogram  ->  کیلوگرم
kilometre  ->  کیلومتر
king  ->  پادشاه
kiss  ->  بوسه
kit  ->  کیت
kite  ->  بادبادک
lake  ->  دریاچه
lamp  ->  لامپ
laptop  ->  لپ تاپ
large  ->  بزرگ
latest  ->  آخرین
laugh  ->  خنده
lazy  ->  تنبل
least  ->  کمترین
leather  ->  چرم
left  ->  ترک کرد
left-hand  ->  دست چپ
lemon  ->  لیمو
lemonade  ->  لیموناد
lend  ->  قرض دادن
less  ->  کمتر
let  ->  اجازه دهید
level  ->  مرحله
library  ->  کتابخانه
licence  ->  مجوز
lie1  ->  bind1
lift  ->  بلند کردن
line  ->  خط
lion  ->  شیر نر
list  ->  فهرست
litre  ->  لیتر
lose  ->  از دست دادن
lost  ->  گمشده
loud  ->  با صدای بلند
lovely  ->  دوست داشتني
low  ->  کم
luck  ->  شانس
lucky  ->  خوش شانس
luggage  ->  بار مسافر
lunchtime  ->  وقت ناهار
machine  ->  دستگاه
mad  ->  دیوانه
magazine  ->  مجله
magic  ->  شعبده بازي
mail  ->  پست
main course  ->  غذای اصلی
make-up  ->  آرایش
manager  ->  مدیر
mango  ->  انبه
map  ->  نقشه
mark  ->  علامت گذاری
market  ->  بازار
married  ->  متاهل
match  ->  همخوانی داشتن
maths  ->  ریاضی
matter  ->  موضوع
maybe  ->  شاید
mean  ->  منظور داشتن
mechanic  ->  مکانیک
medicine  ->  پزشکی
meeting  ->  ملاقات
melon  ->  خربزه
member  ->  عضو
memory  ->  حافظه
menu  ->  منو
metre  ->  متر
midday  ->  یکی
middle  ->  وسط
midnight  ->  نیمه شب
might  ->  ممکن
million  ->  میلیون
mind  ->  ذهن
mine  ->  مال خودم
mineral water  ->  آب معدنی
minus  ->  منهای
mirror  ->  آینه
missing  ->  گم شده
mistake  ->  اشتباه
mix  ->  مخلوط کردن
model  ->  مدل
modern  ->  نوین
moment  ->  لحظه
monkey  ->  میمون
moon  ->  ماه
mosque  ->  مسجد
most  ->  اکثر
motorbike  ->  موتور سیکلت
motorway  ->  بزرگراه
mountain  ->  کوه
mouse  ->  موش
move  ->  حرکت
mp3 player  ->  پخش کننده mp3
ms  ->  خانم
mug  ->  لیوان
mushroom  ->  قارچ
musical  ->  موزیکال
must  ->  باید
myself  ->  خودم
national  ->  ملی
nature  ->  طبیعت
nearly  ->  تقریبا
neck  ->  گردن
necklace  ->  گردنبند
negative  ->  منفی
neighbour  ->  همسایه
net  ->  خالص
news  ->  اخبار
ninety  ->  نود
ninth  ->  نهم
nobody  ->  هيچ كس
noisy  ->  پر سر و صدا
noon  ->  ظهر
no one  ->  هیچکس
normal  ->  طبیعی
north (also north)  ->  شمال (همچنین شمال)
notebook  ->  نوت بوک
nothing  ->  هیچ چی
notice  ->  اطلاع
nurse  ->  پرستار
occupation  ->  اشتغال
off  ->  خاموش
offer  ->  پیشنهاد
office  ->  دفتر
oil  ->  روغن
omelette  ->  املت
once  ->  یک بار
onion  ->  پیاز
opera  ->  اپرا
opposite  ->  مقابل
order  ->  سفارش
ours  ->  مال ما
ourselves  ->  خودمان
out  ->  بیرون
out of  ->  بیرون از
over  ->  بر فراز
own  ->  خود
pack  ->  بسته
pain  ->  درد
painter  ->  نقاش
painting  ->  رنگ آمیزی
pale  ->  رنگ پریده
pardon  ->  عفو
partner  ->  شریک
pass  ->  عبور
passenger  ->  مسافر
passport  ->  گذرنامه
pasta  ->  پاستا
path  ->  مسیر
pc  ->  کامپیوتر
pear  ->  گلابی
pence  ->  پنس
penfriend  ->  دوست قلم
pepper  ->  فلفل
per  ->  مطابق
perfume  ->  عطر
perhaps  ->  شاید
petrol  ->  بنزین
petrol station  ->  پمپ بنزین
photograph  ->  عکس
photographer  ->  عکاس
photography  ->  عکاسی
physics  ->  فیزیک
piano  ->  پیانو
pick  ->  انتخاب
piece  ->  قطعه
pillow  ->  بالش
pilot  ->  خلبان
pink  ->  رنگ صورتی
pity  ->  حیف
plan  ->  طرح
plastic  ->  پلاستیک
platform  ->  سکو
playground  ->  زمین بازی
pleasant  ->  دلپذیر
pleased  ->  راضی
plural  ->  جمع
plus  ->  به علاوه
pocket  ->  جیب
point  ->  نقطه
police  ->  پلیس
policeman  ->  پلیس
police officer  ->  مامور پلیس
police station  ->  ایستگاه پلیس
policewoman  ->  پلیس زن
polite  ->  با ادب
pool  ->  استخر
pop  ->  ترکیدن
popular  ->  محبوب
possibly  ->  احتمالا
post  ->  پست
postcard  ->  کارت پستال
poster  ->  پوستر
post office  ->  اداره پست
pound  ->  پوند
practice  ->  تمرین
pray  ->  نماز خواندن
prefer  ->  ترجیح می دهند
prepare  ->  آماده کردن
pretty  ->  بسیار
price  ->  قیمت
print  ->  چاپ
printer  ->  چاپگر
prize  ->  جایزه
probably  ->  شاید
program  ->  برنامه
programme  ->  برنامه
project  ->  پروژه
pub  ->  میخانه
pull  ->  کشیدن
pupil  ->  شاگرد
purple  ->  رنگ بنفش
purse  ->  کیف پول
push  ->  فشار دادن
puzzle  ->  پازل
queen  ->  ملکه
quickly  ->  به سرعت
quiet  ->  ساکت
quite  ->  کاملا
quiz  ->  مسابقه
rabbit  ->  خرگوش
race  ->  نژاد
racket  ->  راکت تنیس
railway  ->  راه آهن
raincoat  ->  لباس بارانی
rap  ->  رپ
rat  ->  موش صحرایی
real  ->  واقعی
reason  ->  دلیل
receipt  ->  اعلام وصول
receive  ->  دريافت كردن
receptionist  ->  مسئول پذیرش
rent  ->  اجاره
repair  ->  تعمیر
repeat  ->  تکرار
rest  ->  باقی مانده
return  ->  برگشت
rich  ->  ثروتمند
right-hand  ->  دست راست
ring  ->  حلقه
roast  ->  کباب
rock  ->  سنگ
roof  ->  سقف
round  ->  گرد
roundabout  ->  میدان
rubber  ->  لاستیک
rugby  ->  راگبی
ruler  ->  خط كش
runner  ->  دونده
running  ->  در حال اجرا
sailing  ->  کشتیرانی
salad  ->  سالاد
sale  ->  فروش
salesperson  ->  فروشنده
sauce  ->  سس
sausage  ->  سوسیس
save  ->  صرفه جویی
scarf  ->  روسری
schoolchild  ->  دانش آموز
science  ->  علوم پایه
scissors  ->  قیچی
scooter  ->  اسکوتر
screen  ->  صفحه نمایش
seat  ->  صندلی
secretary  ->  دبیر، منشی
sell  ->  فروش
serve  ->  خدمت
set  ->  تنظیم
seventh  ->  هفتم
seventy  ->  هفتاد
several  ->  چندین
shall  ->  باید
shame  ->  شرم
shampoo  ->  شامپو
share  ->  اشتراک گذاری
sheet  ->  ورق
shelf  ->  تاقچه
ship  ->  کشتی
shop assistant  ->  فروشنده مغازه
shorts  ->  شلوار کوتاه
should  ->  باید
shout  ->  فریاد
shut  ->  بسته
sick  ->  بیمار
side  ->  سمت
sightseeing  ->  تماشا
sign  ->  امضاء کردن
silver  ->  نقره
simple  ->  ساده
since  ->  از آنجا که
singer  ->  خواننده
singing  ->  آواز خواندن
single  ->  تنها
singular  ->  مفرد
sink  ->  فرو رفتن
site  ->  سایت
sitting room  ->  اتاق نشیمن
sixth  ->  ششم
sixty  ->  شصت
size  ->  اندازه
skate  ->  اسکیت
skateboard  ->  اسکیت برد
skateboarding  ->  ورزش اسکیت بورد
skating  ->  اسکیت سواری
skiing  ->  اسکی کردن
sky  ->  آسمان
slice  ->  تکه
slowly  ->  به آرامی
snack  ->  خوراک مختصر
snake  ->  مار
snowboarding  ->  اسنوبورد
so  ->  بنابراین
soap  ->  صابون
sock  ->  جوراب
sofa  ->  کاناپه
soft  ->  نرم
soft drink  ->  نوشیدنی غیر الکلی
software  ->  نرم افزار
somebody  ->  کسی
someone  ->  کسی
somewhere  ->  جایی
song  ->  ترانه
sort  ->  مرتب سازی
soul  ->  روح
sound  ->  صدا
south (also south)  ->  جنوب (همچنین جنوب)
space  ->  فضا
spare  ->  یدکی
speaker  ->  گوینده
special  ->  خاص
spell  ->  هجی کردن
spelling  ->  املا
spend  ->  خرج کردن
spoon  ->  قاشق
sports centre  ->  مرکز ورزشی
spring  ->  بهار
square  ->  مربع
stadium  ->  استادیوم
staff  ->  کارکنان
stage  ->  صحنه
stairs  ->  پله ها
stamp  ->  مهر
stand  ->  ایستادن
star  ->  ستاره
steak  ->  استیک
steal  ->  کش رفتن
still  ->  هنوز
stomach  ->  معده
stomach ache  ->  معده درد
storm  ->  طوفان
story  ->  داستان
straight  ->  سر راست
strange  ->  عجیب
strong  ->  قوی
such  ->  چنین
suit  ->  کت و شلوار
suitcase  ->  چمدان
sunglasses  ->  عینک آفتابی
sunny  ->  آفتابی
superlative  ->  برتر
supper  ->  عصرانه
suppose  ->  فرض کنید
sure  ->  مطمئن
surf  ->  موج سواری
surfing  ->  موج سواری
surname  ->  نام خانوادگی
surprise  ->  تعجب
surprised  ->  غافلگیر شدن
sweater  ->  ژاکت
sweets  ->  شیرینی ها
swimming  ->  شنا کردن
swimming costume  ->  لباس شنا
table tennis  ->  تنیس روی میز
team  ->  تیم
teenager  ->  نوجوان
telephone  ->  تلفن
temperature  ->  درجه حرارت
term  ->  مدت، اصطلاح
terrible  ->  وحشتناک
text  ->  متن
textbook  ->  کتاب درسی
text message  ->  پیام متنی
thank  ->  تشکر
theatre  ->  تئاتر
theirs  ->  آنها
themselves  ->  خودشان
thin  ->  لاغر
third  ->  سوم
thirsty  ->  تشنه
thirty  ->  سی
thousand  ->  هزار
through  ->  از طریق
throw  ->  پرت كردن
thunderstorm  ->  رعد و برق
tidy  ->  مرتب
tie  ->  کراوات
tights  ->  لباس تنگ
till  ->  تا
timetable  ->  جدول زمانی
toast  ->  نان تست
toe  ->  انگشت پا
toothache  ->  دندان درد
toothbrush  ->  مسواک
top  ->  بالا
tour  ->  تور
tour guide  ->  راهنمای تور
tourist  ->  توریست
towel  ->  حوله
toy  ->  اسباب بازی
traffic  ->  ترافیک
traffic light  ->  چراغ راهنمایی و رانندگی
trainer  ->  مربی
tram  ->  تراموا
trip  ->  سفر
true  ->  درست است، واقعی
try  ->  تلاش كردن
tune  ->  اهنگ
turn  ->  دور زدن
twice  ->  دو برابر
type  ->  نوع
tyre  ->  لاستیک
umbrella  ->  چتر
uncle  ->  عمو یا دایی
unfortunately  ->  متاسفانه
unhappy  ->  ناراضی
uniform  ->  لباس فرم
unusual  ->  غیر معمول
upset  ->  ناراحت
useful  ->  مفید
usual  ->  معمولی
usually  ->  معمولا
variety  ->  تنوع
various  ->  مختلف
video  ->  ویدئو
video game  ->  بازی ویدیویی
view  ->  چشم انداز
violin  ->  ویولن
visitor  ->  بازدید کننده
vocabulary  ->  واژگان
volleyball  ->  والیبال
walking  ->  پیاده روی
wallet  ->  کیف پول
war  ->  جنگ
washing machine  ->  ماشین لباسشویی
washing-up  ->  شستن
way  ->  مسیر
web  ->  وب
web page  ->  صفحه وب
weekday  ->  روز هفته
weekly  ->  هفتگی
welcome  ->  خوش آمدی
well-known  ->  مشهور - معروف
west (also west)  ->  غرب (همچنین غربی)
wet  ->  مرطوب
wheel  ->  چرخ
while  ->  در حالی که
whole  ->  کل
wide  ->  وسیع
wild  ->  وحشی
win  ->  پیروزی
windy  ->  بادی
winner  ->  برنده
wish  ->  آرزو کردن
without  ->  بدون
wonderful  ->  فوق العاده
wood  ->  چوب
wooden  ->  چوبی
wool  ->  پشم
worker  ->  کارگر
worried  ->  نگران
worse  ->  بدتر
worst  ->  بدترین
yet  ->  هنوز
yogurt (also yoghurt)  ->  ماست (همچنین ماست)
yours  ->  مال شما
yourself  ->  خودت
zero  ->  صفر

B1
--
ability  ->  توانایی
abroad  ->  خارج از کشور
absent  ->  غایب
absolutely  ->  کاملا
accent  ->  لهجه
accept  ->  تایید کنید
acceptable  ->  قابل قبول
access  ->  دسترسی داشته باشید
accommodation  ->  محل اقامت
accompany  ->  همراهی کردن
according to  ->  مطابق با
account  ->  حساب
accountant  ->  حسابدار
accurate  ->  دقیق
accurately  ->  به درستی
ache  ->  درد
achieve  ->  رسیدن
achievement  ->  دستاورد
act  ->  عمل کنید
action  ->  عمل
active  ->  فعال
ad  ->  آگهی
addition  ->  علاوه بر این
admire  ->  تحسین
admission  ->  پذیرش
admit  ->  اقرار کردن
advance  ->  پیشرفت
advantage  ->  مزیت - فایده - سود - منفعت
advert  ->  آگهی
advertise  ->  تبلیغات
advise  ->  توصیه
afford  ->  استطاعت داشتن
agency  ->  آژانس
ages  ->  سنین
ahead  ->  در پیش
aim  ->  هدف
air conditioning  ->  تهویه مطبوع
air force  ->  نیروی هوایی
airline  ->  شرکت هواپیمایی
alarm  ->  زنگ خطر. هشدار
alcoholic  ->  الکلی
alike  ->  یکسان
alive  ->  زنده
allow  ->  اجازه
aloud  ->  با صدای بلند
alphabet  ->  الفبا
although  ->  با اينكه
altogether  ->  در مجموع
amazed  ->  شگفت زده
amazingly  ->  شگفت آور
ambition  ->  هدف - آرزو
amount  ->  میزان
amusing  ->  سرگرم کننده
angel  ->  فرشته
angrily  ->  با عصبانیت
animated  ->  متحرک
animation  ->  انیمیشن
ankle  ->  مچ پا
anniversary  ->  سالگرد
announce  ->  اعلام
announcement  ->  اعلامیه
annoy  ->  آزار دادن
annoyed  ->  اذیت شده
annoying  ->  مزاحم
annual  ->  سالانه
ant  ->  مورچه
antique  ->  عتیقه
anxious  ->  مشتاق
apart  ->  جدا از هم
apologise  ->  عذر خواهی کردن
apology  ->  معذرت خواهی
appear  ->  به نظر می رسد
appearance  ->  ظاهر
application  ->  کاربرد
apply  ->  درخواست دادن
approach  ->  رویکرد
approve  ->  تایید
approximately  ->  تقریبا
architect  ->  معمار
architecture  ->  معماری
argue  ->  جر و بحث
argument  ->  بحث و جدل
army  ->  ارتش
arrange  ->  ترتیب دادن
arrangement  ->  ترتیب
arrest  ->  دستگیری
arrival  ->  ورود
article  ->  مقاله
ashamed  ->  شرمنده
asleep  ->  خواب
aspirin  ->  آسپرین
athlete  ->  ورزشکار
athletics  ->  ورزشکاری
atmosphere  ->  جو
attach  ->  ضمیمه کردن
attack  ->  حمله کنند
attempt  ->  تلاش
attend  ->  مراجعه كردن
attitude  ->  نگرش
attract  ->  جذب کنند
attraction  ->  جاذبه
audience  ->  حضار
author  ->  نویسنده
average  ->  میانگین
avoid  ->  اجتناب کردن
awake  ->  بیدار
awful  ->  خیلی بد و ناخوشایند
babysit  ->  پرستار بچه
babysitter  ->  پرستار بچه
backache  ->  كمر درد
background  ->  زمینه
backpack  ->  کوله پشتی
backpacker  ->  کوله گرد
backpacking  ->  کوله پشتی
backwards  ->  به عقب
bacon  ->  بیکن
baggage  ->  بار سفر
baker  ->  نانوا
balcony  ->  بالکن
bald  ->  بدون مو
ballet  ->  باله
bandage  ->  بانداژ
bank account  ->  حساب بانکی
barber  ->  سلمانی
barman  ->  بارمن
base  ->  پایه
basic  ->  پایه ای
basin  ->  حوضه
basket  ->  سبد
battle  ->  نبرد
bay  ->  خلیج
beat  ->  ضرب و شتم
beautifully  ->  به زیبایی
beauty  ->  زیبایی
because of  ->  به خاطر اینکه
bee  ->  زنبور عسل
beef  ->  گوشت گاو
behave  ->  رفتار كردن
behaviour  ->  رفتار - اخلاق
bell  ->  زنگ
benefit  ->  سود
besides  ->  بعلاوه
bet  ->  شرط
bin  ->  صندوقچه
biography  ->  زندگینامه
birth  ->  تولد
bite  ->  گاز گرفتن
bitter  ->  تلخ
blame  ->  سرزنش کردن
blank  ->  جای خالی
bleed  ->  خونریزی
blind  ->  کور
block  ->  مسدود کردن
blog  ->  وبلاگ
blogger  ->  وبلاگ نویس
blow  ->  فوت کردن، دمیدن
bold  ->  پررنگ
bomb  ->  بمب
bone  ->  استخوان
booking  ->  رزرو
border  ->  مرز
boxing  ->  مشت زنی
bracelet  ->  دستبند
brake  ->  ترمز
branch  ->  شاخه
brand new  ->  کاملا نو
brave  ->  شجاع
bravely  ->  دلیرانه
breast  ->  پستان
breath  ->  نفس
breathe  ->  نفس کشیدن
breeze  ->  نسیم
bride  ->  عروس
brief  ->  مختصر
briefly  ->  به طور خلاصه
broad  ->  گسترده
broccoli  ->  کلم بروکلی
brochure  ->  بروشور
bucket  ->  سطل
bug  ->  حشره
builder  ->  سازنده
bull  ->  گاو نر
bunch  ->  دسته
burn  ->  سوختن
burning  ->  سوزش
bury  ->  دفن کردن
butcher  ->  قصاب
butterfly  ->  پروانه
button  ->  دکمه
buyer  ->  خریدار
cab  ->  تاکسی
cabbage  ->  کلم
cabin  ->  کابین
cable  ->  کابل
cage  ->  قفس
calculator  ->  ماشین حساب
calf  ->  گوساله
calm  ->  آرام
camel  ->  شتر
campsite  ->  کمپینگ
canal  ->  کانال
cancel  ->  لغو
cancer  ->  سرطان
candidate  ->  نامزد
candle  ->  شمع
canteen  ->  سالن غذاخوری
captain  ->  کاپیتان
career  ->  حرفه
careless  ->  بی توجه
cashpoint  ->  امتیازهای نقدی
casual  ->  گاه به گاه
cattle  ->  گاو
cave  ->  غار
cd-rom  ->  سی دی رام
celebrate  ->  جشن گرفتن
celebration  ->  جشن
celebrity  ->  فرد مشهور
central  ->  مرکزی
central heating  ->  گرمایش مرکزی
ceremony  ->  مراسم
certain  ->  مسلم - قطعی
certificate  ->  گواهی
challenge  ->  چالش
challenging  ->  چالش برانگیز
champion  ->  قهرمان
championship  ->  قهرمانی
chance  ->  شانس. فرصت
chapter  ->  فصل
character  ->  شخصیت
charge  ->  شارژ
charity  ->  خیریه
charming  ->  جذاب
chat show  ->  نمایش چت
check-in (counter)  ->  ورود (پیشخوان)
check-in (desk)  ->  پذیرش (میز)
checkout  ->  وارسی
cheek  ->  گونه
cheerful  ->  بشاش
cheers!  ->  به سلامتی!
chest of drawers  ->  صندوق عقب
chewing gum  ->  آدامس
childhood  ->  دوران کودکی
chin  ->  چانه
choice  ->  انتخاب
circus  ->  سیرک
clap  ->  کف زدن
cliff  ->  صخره
climate  ->  اقلیم
clinic  ->  درمانگاه
adv  ->  adv
coast  ->  ساحل
coconut  ->  نارگیل
cod  ->  کد
coin  ->  سکه
collar  ->  یقه
collection  ->  مجموعه
colourful  ->  رنگارنگ
comedy  ->  کمدی
comma  ->  کاما
comment  ->  اظهار نظر
common  ->  مشترک
common sense  ->  حس مشترک
communicate  ->  برقراری ارتباط
communication  ->  ارتباط
compare  ->  مقایسه کنید
compete  ->  رقابت کنند
competitor  ->  رقیب
complain  ->  شكايت كردن
complaint  ->  شکایت
completely  ->  به صورت کامل
complicated  ->  بغرنج
composition  ->  ترکیب بندی
concentrate  ->  تمرکز
conclusion  ->  نتیجه
condition  ->  وضعیت
conference  ->  کنفرانس
confident  ->  مطمئن
confirm  ->  تایید
confused  ->  سردرگم
confusing  ->  گیج کننده
connect  ->  متصل شود
connection  ->  ارتباط
consider  ->  در نظر گرفتن
consist  ->  تشکیل شده است از
consonant  ->  همخوان
contain  ->  حاوی
contents  ->  فهرست
contest  ->  مسابقه
continent  ->  قاره
continue  ->  ادامه هید
control  ->  کنترل
convenient  ->  راحت
convince  ->  متقاعد کردن
corn  ->  ذرت
correction  ->  تصحیح
correctly  ->  به درستی
cosy  ->  دنج
cottage  ->  کلبه
cotton  ->  پنبه
cough  ->  سرفه کردن
count  ->  شمردن
count noun  ->  اسم شمارش
couple  ->  زن و شوهر
courgette  ->  کدو سبز
court  ->  دادگاه
crash  ->  تصادف در
create  ->  ایجاد کردن
creative  ->  خلاق
creature  ->  موجود
credit  ->  اعتبار
crew  ->  خدمه
crime  ->  جرم
criminal  ->  جنایی
crop  ->  محصول
crossing  ->  عبور
cruel  ->  ظالمانه
cruise  ->  کشتی تفریحی
cucumber  ->  خیار
cultural  ->  فرهنگی
culture  ->  فرهنگ
curious  ->  کنجکاو
curiously  ->  کنجکاو
curly  ->  فرفری
currency  ->  واحد پول
curriculum  ->  برنامه تحصیلی
cushion  ->  کوسن
custom  ->  سفارشی
customs  ->  گمرک
cv  ->  رزومه
cycle  ->  چرخه
cyclist  ->  دوچرخه سوار
damage  ->  خسارت
damaged  ->  آسیب دیده
damn  ->  لعنتی
dangerously  ->  خطرناک
deaf  ->  کر
deal  ->  معامله
death  ->  مرگ
decision  ->  تصمیم گیری
declare  ->  اعلام
decorate  ->  تزئین کنید
defeat  ->  شکست
defence  ->  دفاع
defend  ->  دفاع
definite article  ->  مقاله قطعی
definitely  ->  قطعا
delete  ->  حذف
delicious  ->  خوشمزه - لذیذ
delighted  ->  خوشحال
deliver  ->  ارائه
delivery  ->  تحویل
demand  ->  تقاضا
depart  ->  رفتن
departure  ->  عزیمت، خروج
depend  ->  بستگی دارد
deposit  ->  سپرده
depressed  ->  افسرده
depth  ->  عمق
description  ->  شرح
deserve  ->  سزاوار
design  ->  طرح
designer  ->  طراح
despite  ->  با وجود
destination  ->  مقصد
destroy  ->  از بین رفتن
detective  ->  کاراگاه
develop  ->  توسعه دهد
development  ->  توسعه
diagram  ->  نمودار
dial  ->  شماره گیری کنید
diet  ->  رژیم غذایی
differently  ->  متفاوت
difficulty  ->  دشواری
dig  ->  حفر کردن
direct  ->  مستقیم
direction  ->  جهت
directly  ->  به طور مستقیم
director  ->  کارگردان
dirt  ->  خاک
disabled  ->  معلول
disadvantage  ->  عیب
disagree  ->  مخالف بودن
disappear  ->  ناپدید می شوند
disappoint  ->  ناامید کردن
disappointed  ->  ناامید شده
disappointing  ->  ناامید کننده
disappointment  ->  ناامیدی
disc  ->  دیسک
disc jockey  ->  دیسک جوکی
discover  ->  کشف کردن
discussion  ->  بحث
disease  ->  مرض
disgusting  ->  چندش آور
dishwasher  ->  ماشین ظرفشویی
disk  ->  دیسک
dislike  ->  دوست نداشتن
display  ->  نمایش دادن
distance  ->  فاصله
district  ->  ناحیه
dive  ->  شیرجه رفتن
diver  ->  غواص
divide  ->  تقسیم کردن
diving  ->  شیرجه زدن
divorce  ->  طلاق
divorced  ->  جدا شده
dj  ->  دی جی
documentary  ->  مستند
dolphin  ->  دلفین
donkey  ->  الاغ
dot  ->  نقطه
doubt  ->  شک
dozen  ->  دوجین
drag  ->  بکشید
drama  ->  نمایش
drop  ->  رها کردن
due  ->  ناشی از
dull  ->  کدر
dust  ->  گرد و خاک
dustbin  ->  زباله دانی
dusty  ->  گرد و خاکی
duty  ->  وظیفه
duty-free  ->  بخشوده از حقوق گمرکی
duvet  ->  لحاف
earache  ->  گوش درد
earth  ->  زمین
eastern (also eastern)  ->  شرقی (همچنین شرقی)
easygoing (easy-going)  ->  راحت (آسان)
economics  ->  اقتصاد
edge  ->  حاشیه، غیرمتمرکز
education  ->  تحصیلات
effect  ->  اثر
efficient  ->  کارآمد
effort  ->  تلاش
either  ->  یا
elbow  ->  آرنج
elder  ->  بزرگتر
elderly  ->  مسن
eldest  ->  بزرگتر
election  ->  انتخابات
electrical  ->  برقی
electronic  ->  الکترونیکی
elementary  ->  ابتدایی
embarrassed  ->  خجالت زده
embarrassing  ->  شرم آور
embassy  ->  سفارت
emergency  ->  اضطراری
employ  ->  استخدام کردن
employee  ->  کارمند
employer  ->  کارفرما
employment  ->  استخدام
encourage  ->  تشويق كردن
ending  ->  پایان دادن
enemy  ->  دشمن
energy  ->  انرژی
engaged  ->  نامزد شده
engineering  ->  مهندسی
enjoyable  ->  لذت بخش
enormous  ->  عظیم
enquiry (uk also inquiry)  ->  استعلام (استعلام بریتانیا نیز)
entertain  ->  سرگرم کردن
entertainment  ->  سرگرمی
entry  ->  ورود
environment  ->  محیط
environmental  ->  محیطی
equal  ->  برابر
equipment  ->  تجهیزات
escape  ->  در رفتن
essay  ->  مقاله
event  ->  رویداد
exact  ->  دقیق
examiner  ->  ممتحن
exchange  ->  تبادل
exchange rate  ->  قیمت ارز
excitedly  ->  با هیجان
excitement  ->  هیجان
exhausted  ->  خسته
exhibition  ->  نمایشگاه
exist  ->  وجود داشته باشد
expect  ->  انتظار
expedition  ->  اعزام
experience  ->  تجربه
expert  ->  کارشناس
explanation  ->  توضیح
explode  ->  منفجر شود
explore  ->  کاوش
extraordinary  ->  خارق العاده
extremely  ->  فوق العاده
extreme sports  ->  ورزش های شدید
face to face  ->  رو در رو
face-to-face  ->  رو در رو
facilities  ->  امکانات
fairly  ->  منصفانه
false  ->  نادرست
familiar  ->  آشنا
fancy  ->  تفننی
fare  ->  کرایه
farming  ->  کشاورزی
fashionable  ->  مد روز
fasten  ->  بستن
fault  ->  عیب
favour  ->  لطف
fax  ->  فکس
fear  ->  ترس
fee  ->  هزینه
feed  ->  خوراک
feeling  ->  احساس
female  ->  زن
ferry  ->  کشتی
festival  ->  جشنواره
fetch  ->  رفتن و آوردن
fever  ->  تب
fiction  ->  داستان
fight  ->  مبارزه کردن
figure  ->  شکل
film-maker (also filmmaker)  ->  فیلمساز (همچنین فیلمساز)
firefighter  ->  آتش نشان
fire station  ->  ایستگاه آتشنشانی
firework  ->  آتش بازی
firm  ->  محکم
first-floor  ->  طبقه اول
fitness  ->  تناسب اندام
fix  ->  ثابت
flag  ->  پرچم
flavour  ->  طعم و مزه
float  ->  شناور
flood  ->  سیل
flour  ->  ارد
flow  ->  جریان
flu  ->  آنفولانزا
flute  ->  فلوت
fold  ->  تا کردن
folk  ->  مردم
following  ->  ذیل
fond  ->  دوست داشتنی
fool  ->  احمق
forbidden  ->  ممنوع
forecast  ->  پیش بینی
forehead  ->  پیشانی
foreigner  ->  خارجی
forever (also for ever)  ->  برای همیشه (همچنین برای همیشه)
forgive  ->  ببخش
former  ->  سابق
fortnight  ->  دو هفته
fortunately  ->  خوشبختانه
forward  ->  رو به جلو
fountain  ->  آبنما
frame  ->  قاب
freeze  ->  یخ زدگی
freezer  ->  فریزر
freezing  ->  انجماد
frequent  ->  زود زود
frequently  ->  مکررا
friendship  ->  دوستی
frightened  ->  وحشت زده
frightening  ->  ترسناک
frog  ->  قورباغه
frozen  ->  منجمد
fry  ->  سرخ کردن
frying pan  ->  ماهیتابه
fuel  ->  سوخت
full stop  ->  توقف کامل
full-time  ->  تمام وقت
fully  ->  به طور کامل
fur  ->  خز
furthest  ->  دورترین
gain  ->  کسب کردن
gallery  ->  گالری
gap  ->  شکاف
gay  ->  همجنس گرا
general  ->  عمومی
generally  ->  بطور کلی
generation  ->  نسل
generous  ->  سخاوتمندانه
gentle  ->  ملایم
ghost  ->  روح
giant  ->  غول
giraffe  ->  زرافه
glance  ->  نگاه
goalkeeper  ->  دروازه بان
goat  ->  بز
goods  ->  کالاها
gorgeous  ->  جذاب
government  ->  دولت
grab  ->  گرفتن
grade  ->  مقطع تحصیلی
grant  ->  اعطا کردن
graphics  ->  گرافیک
grateful  ->  سپاسگزار
greet  ->  سلام کردن
greeting  ->  سلام و احوال پرسی
grill  ->  کباب
groom  ->  داماد
ground  ->  زمین
guard  ->  نگهبان
guilty  ->  گناهکار
guitarist  ->  گیتاریست
gun  ->  تفنگ
gym  ->  سالن ورزش
gymnastics  ->  ژیمناستیک
habit  ->  عادت داشتن
haircut  ->  اصلاح مو
hairdresser  ->  آرایشگاه
hairdryer  ->  سشوار
handball  ->  هندبال
hand-held  ->  دستی
handkerchief  ->  دستمال
handle  ->  رسیدگی
handsome  ->  خوش قیافه
handwriting  ->  دست خط
hang  ->  آویزان شدن
happily  ->  با خوشحالی
happiness  ->  شادی
harbour  ->  بندرگاه
hardly  ->  به ندرت
hardware  ->  سخت افزار
headline  ->  عنوان
heart attack  ->  حمله قلبی
heat  ->  حرارت
heater  ->  بخاری
heavily  ->  به شدت
heel  ->  پاشنه
height  ->  ارتفاع
helpful  ->  مفید است
herb  ->  گیاه دارویی
hero  ->  قهرمان
hidden  ->  پنهان شده است
hide  ->  پنهان شدن
hire  ->  استخدام
historic  ->  تاریخی
historical  ->  تاریخی
hitchhike  ->  مسافرت مفتی
hole  ->  سوراخ
honest  ->  صادقانه
honestly  ->  صادقانه
honeymoon  ->  ماه عسل
hopeful  ->  امیدوار کننده
hopefully  ->  خوشبختانه
hopeless  ->  نومید
horror  ->  وحشت
hostel  ->  خوابگاه
housework  ->  کارهای خانه
hug  ->  در آغوش گرفتن
huge  ->  بزرگ
human  ->  انسان
humid  ->  مرطوب
humour  ->  شوخ طبعی
hunger  ->  گرسنگی
hunt  ->  شکار کردن
hut  ->  کلبه
ice hockey  ->  هاکی روی یخ
ice skating  ->  اسکیت روی یخ
icy  ->  یخی
identity card  ->  کارت شناسایی
illness  ->  بیماری
imagination  ->  خیال پردازی
imagine  ->  تصور کنید
immigration  ->  مهاجرت
importance  ->  اهمیت
impossible  ->  غیر ممکن
improvement  ->  بهبود
inch  ->  اینچ
incorrect  ->  غلط
incredible  ->  باور نکردنی
indeed  ->  در واقع
indefinite article  ->  حرف نامعین
independent  ->  مستقل
individual  ->  شخصی
indoors  ->  در داخل خانه
industry  ->  صنعت
inexpensive  ->  ارزان
infinitive  ->  مصدر
inform  ->  آگاه کردن
ingredient  ->  جزء
initial  ->  اولیه
injure  ->  زخمی کردن
ink  ->  جوهر
inquiry (uk also enquiry)  ->  استعلام (پرس و جو در انگلستان نیز)
insist  ->  اصرار کنید
install (uk also instal)  ->  نصب (در انگلستان نیز نصب کنید)
instance  ->  نمونه، مثال
instructor  ->  مربی
intelligent  ->  باهوش
intend  ->  قصد داشتن - خواستن
interest  ->  علاقه
intermediate  ->  حد واسط
internationally  ->  در سطح بین المللی
interrupt  ->  قطع کردن
interval  ->  فاصله
interview  ->  مصاحبه
introduce  ->  معرفی کنید
invent  ->  اختراع کردن
invention  ->  اختراع
involve  ->  درگیر کردن
iron  ->  اهن
ironing  ->  اتو کردن
irregular  ->  بی رویه
issue  ->  موضوع
item  ->  مورد
jail  ->  زندان
jar  ->  شیشه
jealous  ->  حسود
jet  ->  جت
jog  ->  دویدن
jogging  ->  دویدن
joke  ->  شوخی
journalist  ->  روزنامه نگار
judge  ->  قضاوت کنید
jug  ->  کوزه
juicy  ->  آبدار
jungle  ->  جنگل
kangaroo  ->  کانگورو
keen  ->  تیز
keeper  ->  نگهبان
kettle  ->  کتری
killer  ->  قاتل
killing  ->  کشتن
kindly  ->  محبت آمیز
kitten  ->  بچه گربه
knee  ->  زانو
knickers  ->  چاقو
knit  ->  بافتن
knock  ->  در زدن
knowledge  ->  دانش
known  ->  شناخته شده
lab  ->  آزمایشگاه
label  ->  برچسب
laboratory  ->  آزمایشگاه
lack  ->  عدم
ladder  ->  نردبان
lady  ->  خانم
lamb  ->  گوشت بره
land  ->  زمین
landscape  ->  چشم انداز
lately  ->  در این اواخر
law  ->  قانون
lawyer  ->  وکیل
lay  ->  غیر روحانی
lead  ->  رهبری
leader  ->  رهبر
leaf  ->  برگ
league  ->  لیگ
lecture  ->  سخنرانی
leisure  ->  اوقات فراغت
length  ->  طول
lettuce  ->  کاهو
lie2  ->  دروغ 2
lighter  ->  فندک
lightly  ->  به آرامی
lightning  ->  رعد و برق
likely  ->  احتمال دارد
limit  ->  حد
limited  ->  محدود
link  ->  ارتباط دادن
lip  ->  لب
liquid  ->  مایع
literature  ->  ادبیات
lively  ->  زنده
load  ->  بار
loan  ->  وام
local  ->  محلی
locate  ->  پیدا کردن
location  ->  محل
lock  ->  قفل کردن
logo  ->  لوگو
lonely  ->  تنها
loose  ->  شل
lorry  ->  کامیون
lottery  ->  بخت آزمایی
loudly  ->  با صدای بلند
lover  ->  عاشق
luckily  ->  خوشبختانه
luxury  ->  لوکس
madam  ->  خانم
magnificent  ->  باشکوه
main  ->  اصلی
mainly  ->  به طور عمده
male  ->  نر
mall  ->  مرکز خرید
manage  ->  مدیریت کنید
marriage  ->  ازدواج
marry  ->  ازدواج کن
marvellous  ->  شگفت انگیز
mate  ->  رفیق
material  ->  مواد
maximum  ->  بیشترین
meaning  ->  معنی
meanwhile  ->  در همین حال
medium  ->  متوسط
membership  ->  عضویت
mend  ->  بهبودی یافتن
mess  ->  بهم ریختگی
message board  ->  تابلوی پیام
messy  ->  بی نظم
metal  ->  فلز
method  ->  روش
middle-aged  ->  میانسال
mild  ->  خفیف
mile  ->  مایل
millimetre  ->  میلی متر
minimum  ->  کمترین
miserable  ->  بدبخت
modal (verb)  ->  فعل معین شرطی)
monster  ->  هیولا
monthly  ->  ماهانه
monument  ->  بنای تاریخی
mood  ->  حالت
mosquito  ->  پشه
mostly  ->  اغلب
moustache  ->  سبیل
murder  ->  آدم کشی
murderer  ->  قاتل
musician  ->  نوازنده
mystery  ->  رمز و راز
narrow  ->  محدود، تنگ
nasty  ->  زننده
natural  ->  طبیعی
navy blue  ->  آبی سرمه ای
nearby  ->  در نزدیکی
neat  ->  مرتب
necessary  ->  لازم است
neighbourhood  ->  محله
nephew  ->  پسر خواهر یا برادر
nervous  ->  عصبی
next door  ->  همسایه
next-door  ->  همسایه
niece  ->  دختر برادر یا خواهر و غیره
nightclub  ->  کلوپ شبانه
nightlife  ->  زندگی شبانه
nightmare  ->  کابوس
none  ->  هیچ یک
normally  ->  به طور معمول
northeast (north-east)  ->  شمال شرقی (شمال شرقی)
northern (also northern)  ->  شمالی (همچنین شمالی)
northwest (north-west)  ->  شمال غربی (شمال غربی)
noticeboard  ->  تابلو اعلانات
novel  ->  رمان
nowadays  ->  این روزها
nowhere  ->  هیچ جایی
obvious  ->  واضح
obviously  ->  به طور مشخص
occasion  ->  مناسبت
ocean  ->  اقیانوس
officer  ->  افسر
old-fashioned  ->  سبک قدیمی
olive  ->  زیتون
onto (also on to)  ->  روی (همچنین روی)
operate  ->  عمل کنند
operation  ->  عمل
opinion  ->  نظر
opportunity  ->  فرصت
option  ->  گزینه
orchestra  ->  ارکستر
ordinary  ->  معمولی
organization (also uk organisation)  ->  سازمان (همچنین سازمان بریتانیا)
organize (also uk organise)  ->  سازماندهی (همچنین سازماندهی بریتانیا)
original  ->  اصلی
otherwise  ->  در غیر این صورت
ought to  ->  باید
outdoor  ->  در فضای باز
outdoors  ->  بیرون از خانه
out-of-date  ->  منسوخ
oven  ->  فر
overnight  ->  یک شبه
owe  ->  مدیون
owner  ->  مالک
packet  ->  بسته
painful  ->  دردناک
palace  ->  قصر
pan  ->  ماهی تابه
pants  ->  شلوار
paragraph  ->  پاراگراف
parcel  ->  بسته
parking  ->  توقفگاه خودرو
parrot  ->  طوطی
particular  ->  خاص
particularly  ->  به ویژه
partly  ->  تا حدی
part-time  ->  پاره وقت
passive  ->  منفعل
password  ->  کلمه عبور
patient  ->  صبور
pattern  ->  الگو
pause  ->  مکث
pavement  ->  پیاده رو
pea  ->  نخود
peace  ->  صلح
peaceful  ->  صلح آمیز
peach  ->  هلو
peak  ->  اوج
peanut  ->  بادام زمینی
pedestrian  ->  عابر پیاده
penguin  ->  پنگوئن
penny  ->  پنی
percent (also per cent)  ->  درصد (همچنین درصد)
perfectly  ->  کاملا
perform  ->  انجام دادن
performance  ->  کارایی
performer  ->  بازیگر
period  ->  عادت زنانه
permanent  ->  دائمی
permission  ->  اجازه
personal  ->  شخصی
personally  ->  شخصا
persuade  ->  متقاعد کردن
pharmacy  ->  داروخانه
photocopy  ->  فتوکپی
phrasal verb  ->  فعل چند قسمتی
phrase  ->  عبارت
pie  ->  پای
pile  ->  توده
pill  ->  قرص
pin  ->  سنجاق
pineapple  ->  آناناس
pipe  ->  لوله
pirate  ->  دزد دریایی
plain  ->  جلگه
planet  ->  سیاره
pleasantly  ->  خوشایند
pleasure  ->  لذت
plenty  ->  فراوانی
plug  ->  پلاگین
pocket money  ->  پول توجیبی
poem  ->  شعر
poet  ->  شاعر
poetry  ->  شعر
politely  ->  مودبانه
political  ->  سیاسی
politician  ->  سیاستمدار
politics  ->  سیاست
pollution  ->  آلودگی
population  ->  جمعیت
pork  ->  گوشت خوک
port  ->  بندر
position  ->  موقعیت
positive  ->  مثبت
possessive  ->  مضافالیه
possibility  ->  امکان پذیری
postman  ->  پستچی
postpone  ->  عقب انداختن
pot  ->  گلدان
pour  ->  ریختن
powder  ->  پودر
power  ->  قدرت
powerful  ->  قدرتمند
prayer  ->  دعا
predict  ->  پیش بینی
pregnant  ->  حامله
preparation  ->  آماده سازی
prepared  ->  تهیه شده
prescription  ->  نسخه
presentation  ->  ارائه
president  ->  رئيس جمهور
press  ->  مطبوعات
prevent  ->  جلوگیری کردن
previous  ->  قبلی
previously  ->  قبلا
priest  ->  کشیش
primary school  ->  دبستان
prince  ->  شاهزاده
princess  ->  شاهزاده
principal  ->  اصلی
prison  ->  زندان
prisoner  ->  زندانی
private  ->  خصوصی
product  ->  تولید - محصول
profession  ->  حرفه
professional  ->  حرفه ای
professor  ->  استاد
promise  ->  وعده
promote  ->  ترویج
pronoun  ->  ضمیر
pronounce  ->  تلفظ کنید
pronunciation  ->  تلفظ
proper  ->  مناسب
properly  ->  به درستی
property  ->  ویژگی
protect  ->  محافظت
proud  ->  مغرور
prove  ->  ثابت كردن
provide  ->  فراهم کند
public  ->  عمومی
public transport  ->  حمل و نقل عمومی
publish  ->  انتشار
pullover  ->  پلیور
pump  ->  پمپ
punctuation  ->  نقطه گذاری
punish  ->  تنبیه کردن
puppy  ->  توله سگ
pure  ->  خالص
purpose  ->  هدف
qualification  ->  صلاحیت
qualified  ->  واجد شرایط
quality  ->  کیفیت
quantity  ->  تعداد
question mark  ->  علامت سوال
questionnaire  ->  پرسشنامه
queue  ->  صف
quietly  ->  بی سر و صدا
quit  ->  ترک کردن
rail  ->  ریل
rainforest  ->  جنگل بارانی
rainy  ->  بارانی
raise  ->  بالا بردن
range  ->  دامنه
rare  ->  نادر
rarely  ->  به ندرت
rather  ->  نسبتا
raw  ->  خام
reach  ->  رسیدن
reader  ->  خواننده
realistic  ->  واقع بین
realize (also uk realise)  ->  متوجه شدن (همچنین انگلیسی متوجه شد)
reasonable  ->  معقول
reasonably  ->  منطقی
rebuild  ->  بازسازی کنید
recent  ->  اخیر
recently  ->  به تازگی
reception  ->  پذیرایی
recipe  ->  دستور آشپزی
recognize (also uk recognise)  ->  تشخیص (همچنین در انگلستان تشخیص)
recommend  ->  توصیه
recording  ->  ضبط کردن
recover  ->  بهبود می یابند
recycle  ->  بازیافت
recycled  ->  بازیافت شده
recycling  ->  بازیافت
reduce  ->  کاستن
refreshments  ->  تنقلات
refuse  ->  رد کردن
regard  ->  توجه
region  ->  منطقه
register  ->  ثبت نام
registration  ->  ثبت
regret  ->  پشیمان شدن. پشیمانی
regular  ->  منظم
regularly  ->  به طور منظم
relation  ->  رابطه
relationship  ->  ارتباط
relative  ->  نسبت فامیلی
relax  ->  آروم باش
relaxation  ->  آرامش
relaxed  ->  آرام
relaxing  ->  آرامش بخش
reliable  ->  قابل اعتماد
religion  ->  دین
remain  ->  ماندن
remind  ->  به یاد آوردن
remote control  ->  کنترل از راه دور
remove  ->  برداشتن
replace  ->  جایگزین کردن
reply  ->  پاسخ
report  ->  گزارش
reporter  ->  خبرنگار
request  ->  درخواست
require  ->  نیاز
rescue  ->  نجات
reservation  ->  رزرو
reserve  ->  ذخیره
resort  ->  رفت و آمد مکرر
respect  ->  توجه
responsible  ->  مسئول
result  ->  نتیجه
retire  ->  بازنشسته شدن
review  ->  مرور
revise  ->  تجدید نظر کنید
revision  ->  تجدید نظر
reward  ->  جایزه
rid  ->  خلاص شدن از شر
rider  ->  سوار
rise  ->  بالا آمدن
rob  ->  غارت
robot  ->  ربات
role  ->  نقش
roll  ->  رول
romance  ->  داستان عاشقانه
romantic  ->  رومانتیک
rose  ->  گل سرخ
rough  ->  خشن
route  ->  مسیر
routine  ->  روال
row1  ->  ردیف 1
rubbish  ->  زباله
rude  ->  بی ادب
rug  ->  قالیچه
ruin  ->  خراب کردن
rule  ->  قانون
safely  ->  بدون خطر
sail  ->  سفر دریایی
sailor  ->  ملوان
salary  ->  حقوق
salesman  ->  فروشنده
saleswoman  ->  فروشنده خانم
salmon  ->  ماهی سالمون
sand  ->  شن
sandal  ->  کفش راحتی
sandy  ->  شنی
satisfied  ->  راضی
saucepan  ->  ماهی تابه
saucer  ->  نعلبکی
scared  ->  ترسیده
scary  ->  ترسناک
scene  ->  صحنه
scenery  ->  منظره
science fiction  ->  علمی تخیلی
scientific  ->  علمی
scientist  ->  دانشمند
score  ->  نمره
scream  ->  فریاد زدن
sculpture  ->  مجسمه سازی
search  ->  جستجو کردن
season  ->  فصل
secondary  ->  ثانوی
secondary school  ->  مدرسه راهنمایی
second-hand  ->  دست دوم
secret  ->  راز
secretly  ->  مخفیانه
section  ->  بخش
security  ->  امنیت
seem  ->  به نظر می رسد
select  ->  انتخاب کنید
selfish  ->  خود خواه
self-service  ->  سلف سرویس
seller  ->  فروشنده
sense  ->  احساس، مفهوم
sensible  ->  معقول
series  ->  سلسله
serious  ->  جدی
seriously  ->  به طور جدی
server  ->  سرور
service  ->  سرویس
session  ->  جلسه
sew  ->  دوختن
sex  ->  رابطه ی جنسی
shade  ->  سایه
shadow  ->  سایه
shake  ->  تکان دادن
shape  ->  شکل
shark  ->  کوسه
sharp  ->  تیز
shave  ->  تراشیدن
shine  ->  درخشیدن
shiny  ->  براق
shock  ->  شوکه شدن
shocked  ->  شوکه
shocking  ->  تکان دهنده
shoot  ->  شلیک
shore  ->  ساحل
shortly  ->  به زودی
shoulder  ->  شانه
shy  ->  خجالتی
sight  ->  منظره
signature  ->  امضا
signpost  ->  تابلوی راهنما
silence  ->  سکوت
silent  ->  بی صدا
silk  ->  ابریشم
silly  ->  احمقانه
similar  ->  مشابه
sincerely  ->  خالصانه
situated  ->  واقع شده است
situation  ->  وضعیت
ski  ->  اسکی
skill  ->  مهارت
skin  ->  پوست
sleepy  ->  خواب آلود
sleeve  ->  آستین
slip  ->  لیز خوردن
smart  ->  هوشمندانه
smell  ->  بو
smile  ->  لبخند
smooth  ->  صاف
snowboard  ->  اسنوبرد
soap opera  ->  اپرا صابون
social  ->  اجتماعی
social networking  ->  شبکه اجتماعی
society  ->  جامعه
softly  ->  به نرمی
soldier  ->  سرباز
solution  ->  راه حل
solve  ->  حل
somehow  ->  به نحوی
sore  ->  دردناک
sour  ->  ترش
southeast (south-east)  ->  جنوب شرقی (جنوب شرقی)
southern (also southern)  ->  جنوبی (همچنین جنوبی)
southwest (south-west)  ->  جنوب غربی (جنوب غربی)
souvenir  ->  سوغات
sparkling  ->  درخشان
specially  ->  مخصوصا
spectacular  ->  دیدنی و جذاب - تماشایی
speech  ->  سخن، گفتار
speed  ->  سرعت
spice  ->  ادویه
spicy  ->  تند
spider  ->  عنکبوت
spill  ->  ریختن
spinach  ->  اسفناج
spite  ->  با وجود
split  ->  شکاف
spoil  ->  از بین بردن
sports  ->  ورزش ها
spot  ->  نقطه
spy  ->  جاسوس
squash  ->  اسکواش
stall  ->  غرفه
statue  ->  مجسمه
steep  ->  شیب تند
step  ->  گام
stick  ->  چوب
sticky  ->  چسبنده
stir  ->  هم بزنید
stone  ->  سنگ
store  ->  فروشگاه
stranger  ->  غریبه
strawberry  ->  توت فرنگی
stream  ->  جریان
stress  ->  فشار
stressed  ->  تاکید کرد
stressful  ->  پر استرس
strict  ->  سخت گیرانه
strike  ->  ضربه
stripe  ->  راه راه
studio  ->  استودیو
stuff  ->  چیز
stupid  ->  احمق
style  ->  سبک
stylish  ->  خوش استیل
succeed  ->  موفق شدن
success  ->  موفقیت
successful  ->  موفقیت آمیز
suddenly  ->  ناگهان
suffer  ->  رنج بردن
suggest  ->  پیشنهاد می دهد
suggestion  ->  پیشنهاد
suitable  ->  مناسب
sum  ->  مجموع
sunbathe  ->  آفتاب گرفتن
sunrise  ->  طلوع خورشید
sunset  ->  غروب آفتاب
sunshine  ->  آفتاب
support  ->  پشتیبانی
supporter  ->  حامی
surprising  ->  شگفت آور
surprisingly  ->  به طرز شگفت انگیزی
surround  ->  احاطه
sweatshirt  ->  سویی شرت
swimmer  ->  شناگر
switch  ->  تعویض
system  ->  سیستم
tablet  ->  تبلت
takeaway  ->  بردن
talent  ->  استعداد
talented  ->  با استعداد
tap  ->  ضربه زدن
taste  ->  طعم و مزه
tasty  ->  خوش طعم
tax  ->  مالیات
teaching  ->  درس دادن
tear1  ->  اشک 1
tear2  ->  اشک 2
technique  ->  تکنیک
technology  ->  فن آوری
teenage  ->  نوجوان
temple  ->  معبد
temporary  ->  موقت
tense  ->  زمان فعل
tent  ->  چادر
terribly  ->  به طرز وحشتناکی
terrific  ->  فوق العاده
terrified  ->  وحشت زده
the first floor  ->  طبقه اول
the ground floor  ->  طبقه همکف
therefore  ->  از این رو
the seaside  ->  کناردریا
thick  ->  ضخیم
thief  ->  دزد
though  ->  اگر چه
thought  ->  فکر
thriller  ->  دلهره آور
throat  ->  گلو
thumb  ->  شست
thunder  ->  رعد و برق
tick  ->  تیک بزنید
tiger  ->  ببر
tight  ->  تنگ
tin  ->  قلع
tiny  ->  کوچک
tip  ->  نکته
tiring  ->  خسته کننده
tissue  ->  بافت
title  ->  عنوان
tongue  ->  زبان
toothpaste  ->  خمیر دندان
topic  ->  موضوع
total  ->  جمع
totally  ->  کاملا
touch  ->  دست زدن به
tourism  ->  گردشگری
tournament  ->  مسابقات
towards  ->  به سمت
tower  ->  برج
track  ->  مسیر
tracksuit  ->  لباس ورزشی
trade  ->  تجارت
traditional  ->  سنتی
traffic jam  ->  راهبندان
training  ->  آموزش
translate  ->  ترجمه کردن
translation  ->  ترجمه
travel agent  ->  آژانس مسافرتی
traveller  ->  رهگذر
trend  ->  روند
trick  ->  فوت و فن
trouble  ->  مشکل
truck  ->  کامیون
truly  ->  براستی
trumpet  ->  شیپور
trust  ->  اعتماد
truth  ->  حقیقت
tube  ->  لوله
tuna  ->  ماهی تن
tunnel  ->  تونل
turkey  ->  بوقلمون
turning  ->  پیچ
twin  ->  دوقلو
typical  ->  معمول
typically  ->  معمولا
ugly  ->  زشت
unable  ->  قادر نیست
unbelievable  ->  باور نکردنی
uncomfortable  ->  ناراحت
uncountable noun  ->  اسم غیر قابل شمارش
underline  ->  زیر خط بکش
underneath  ->  در زیر
underpants  ->  زیر شلواری
underwear  ->  زیر شلواری
undress  ->  برهنه
unemployed  ->  بیکار
unemployment  ->  بیکاری
unexpected  ->  غیر منتظره
unfair  ->  غیر منصفانه
unfit  ->  نامناسب
unforgettable  ->  فراموش نشدنی
unfriendly  ->  غیر دوستانه
unhealthy  ->  ناسالم
unimportant  ->  بی اهمیت
uninterested  ->  بی علاقه
uninteresting  ->  غیر جالب
union  ->  اتحاد. اتصال
unit  ->  واحد
universe  ->  کائنات
unkind  ->  نامهربان
unknown  ->  ناشناس
unless  ->  مگر اینکه
unlikely  ->  بعید
unlucky  ->  بد شانس
unnecessary  ->  غیر ضروری
unpack  ->  باز کردن بسته بندی
unpleasant  ->  ناخوشایند
untidy  ->  نامرتب
unwell  ->  ناخوش
upload  ->  بارگذاری
upon  ->  بر
upper  ->  بالا
up-to-date  ->  به روز
urgent  ->  فوری
urgently  ->  فوری
used  ->  استفاده شده
used to  ->  عادت داشتن
useless  ->  بلا استفاده
user  ->  کاربر
valley  ->  دره
valuable  ->  با ارزش
value  ->  ارزش
van  ->  ون
vase  ->  گلدان
vegetarian  ->  گیاه خواری
vehicle  ->  وسیله نقلیه
vet  ->  دامپزشک
via  ->  از طریق
video clip  ->  کلیپ ویدیویی
virus  ->  ویروس
visa  ->  ویزا
voice  ->  صدا
volume  ->  جلد
vote  ->  رای
vowel  ->  حرف صدادار
wage  ->  حق الزحمه
wardrobe  ->  جا رختی
warn  ->  هشدار دهد
warning  ->  هشدار
waste  ->  هدر
waterfall  ->  آبشار
wave  ->  موج
weak  ->  ضعیف
weather forecast  ->  پیش بینی آب و هوا
webcam  ->  وبکم
wedding  ->  عروسی
weigh  ->  وزن کردن
weight  ->  وزن
well-dressed  ->  خوش پوش
western (also western)  ->  غربی (همچنین غربی)
whale  ->  نهنگ
whatever  ->  هر چه
wheelchair  ->  ویلچر
whenever  ->  هر زمان که
wherever  ->  هر کجا که
whether  ->  چه
whose  ->  که
wildlife  ->  حیات وحش
willing  ->  مایل بودن
windscreen  ->  شیشه جلو
windsurfing  ->  موج سواری
wing  ->  بال
within  ->  در داخل
wonder  ->  تعجب
working  ->  کار کردن
workout  ->  تمرین
worth  ->  ارزش
wrap  ->  بسته بندی کردن
writer  ->  نویسنده
written  ->  نوشته شده است
yard  ->  حیاط
yoga  ->  یوگا
youth  ->  جوانان
zone  ->  منطقه

B2
--
abandon  ->  رها کردن
abandoned  ->  رها شده است
abolish  ->  لغو کند
absence  ->  غیبت
absolute  ->  مطلق
absorb  ->  جذب
abstract  ->  چکیده
absurd  ->  چرند
abuse  ->  سو استفاده کردن
academic  ->  علمی
accessible  ->  در دسترس
accidental  ->  تصادفی
accidentally  ->  به طور تصادفی
accuracy  ->  دقت
accuse  ->  متهم کردن
acid  ->  اسید
acquire  ->  بدست آوردن
actively  ->  به طور فعال
actual  ->  واقعی
adapt  ->  سازگار شدن
addict  ->  معتاد
addicted  ->  معتاد
addiction  ->  اعتیاد
additional  ->  اضافی
additionally  ->  علاوه بر این
adequate  ->  کافی است
adequately  ->  به اندازه کافی
adjust  ->  تنظیم کنید
adjustment  ->  تنظیم
admiration  ->  تحسین
admittedly  ->  مسلما
adopt  ->  اتخاذ کردن
adopted  ->  به تصویب رسید
adoption  ->  فرزندخواندگی
adventurous  ->  پرماجرا
advertising  ->  تبلیغات
affair  ->  امر
affect  ->  تاثیر می گذارد
affection  ->  محبت
agent  ->  عامل
aggressive  ->  خشونت آمیز
aggressively  ->  به صورت تهاجمی
agreement  ->  توافق
agriculture  ->  کشاورزی
aircraft  ->  هواپیما
alphabetical  ->  حروف الفبا
alter  ->  تغییر دهید
alternative  ->  جایگزین
alternatively  ->  متناوبا، از سوی دیگر
aluminium  ->  آلومینیوم
amazement  ->  شگفتی
ambassador  ->  سفیر
ambitious  ->  جاه طلب
amongst  ->  در میان
amuse  ->  سرگرم کردن
amused  ->  سرگرم شده
amusement  ->  تفریحی
analyse  ->  تجزیه و تحلیل
analysis  ->  تحلیل و بررسی
analyst  ->  تحلیلگر
ancestor  ->  جد
anger  ->  خشم
annually  ->  سالانه
anxiety  ->  اضطراب
anxiously  ->  با نگرانی
anyhow  ->  در هر صورت
apostrophe  ->  آپستروف
apparent  ->  آشکار
apparently  ->  ظاهرا
appeal  ->  درخواست
appreciate  ->  قدردانی
appreciation  ->  قدردانی
appropriate  ->  مناسب
appropriately  ->  مناسب
approval  ->  تصویب
approximate  ->  تقریبی
armed  ->  مسلح
arrogant  ->  مغرور
arrow  ->  فلش
artificial  ->  ساختگی
artificially  ->  به صورت مصنوعی
artistic  ->  هنری
aside  ->  گذشته از
aspect  ->  جنبه
assess  ->  ارزیابی کنید
assessment  ->  ارزیابی
assist  ->  کمک کند
assistance  ->  معاونت
associate  ->  وابسته
association  ->  اتحادیه
assume  ->  فرض
assure  ->  اطمینان دادن
astonished  ->  حیرت زده
astonishing  ->  عجیب
astonishment  ->  حیرت، شگفتی
athletic  ->  ورزشی
atom  ->  اتم
atomic  ->  اتمی
attached  ->  پیوست شده است
attachment  ->  پیوست
aubergine  ->  بادمجان
authority  ->  قدرت
automatic  ->  خودکار
automatically  ->  بطور خودکار
availability  ->  دسترسی
award  ->  جایزه
aware  ->  آگاه
awkward  ->  بی دست و پا - به شکلی نامناسب
backup (also back-up)  ->  پشتیبان (همچنین پشتیبان)
badge  ->  نشان
bad-tempered  ->  بد اخلاق
bakery  ->  نانوایی
balance  ->  تعادل
balanced  ->  متعادل
ban  ->  ممنوع کردن
bang  ->  انفجار
banker  ->  بانکدار
banking  ->  بانکداری
bare  ->  برهنه
barely  ->  به سختی
bargain  ->  چانه زدن
bark  ->  پارس سگ
barrier  ->  مانع
basement  ->  زیر زمین
basically  ->  اساسا
basics  ->  اصول اولیه
basis  ->  اساس
beam  ->  پرتو
beg  ->  گدایی کردن
behalf  ->  از طرف
belief  ->  باور
belongings  ->  متعلقات
bench  ->  نیمکت
bend  ->  خم شدن
beneath  ->  در زیر
beneficial  ->  سودمند
berry  ->  توت
bestseller  ->  کتاب پرفروش
betray  ->  خیانت کردن
beyond  ->  فراتر
bikini  ->  بیکینی
billion  ->  میلیارد
biological  ->  بیولوژیکی
bizarre  ->  عجیب و غریب
blade  ->  تیغه
blink  ->  چشمک زدن
bloody  ->  خونین
blush  ->  سرخ شدن
boast  ->  به رخ کشیدن
boiling  ->  غلیان
boldly  ->  جسورانه
bomber  ->  بمب افکن
bombing  ->  بمب گذاری
bond  ->  رابطه، رشته
bonus  ->  جایزه
booklet  ->  جزوه
bookmark  ->  نشانک
boost  ->  تقویت
bossy  ->  رئیس
bothered  ->  اذیت شد
bounce  ->  جهش
bound  ->  مقید شده است
bow  ->  تعظیم
bra  ->  سینه بند
bracket  ->  براکت
brand  ->  نام تجاری
bravery  ->  شجاعت
breakable  ->  شکستنی
breakdown  ->  درهم شکستن
breakthrough  ->  پیشرفت
breathtaking  ->  نفس گیر
breed  ->  نژاد
brick  ->  آجر
brightly  ->  روشن
brilliantly  ->  درخشان
broadband  ->  پهنای باند
broadcast  ->  پخش
brother-in-law  ->  برادر شوهر
browse  ->  مرور کردن
browser  ->  مرورگر
bruise  ->  کبودی
budget  ->  بودجه
bulb  ->  لامپ
bullet  ->  گلوله
bump  ->  دست انداز
bumper  ->  سپر
bun  ->  نان
burglar  ->  بورگ ها
burglary  ->  سرقت
burgle  ->  دزدی کردن
burst  ->  ترکیدن
bush  ->  بوته
cabinet  ->  کابینه
calculate  ->  محاسبه
calculation  ->  محاسبه
calmly  ->  با آرامش
campus  ->  محوطه دانشگاه
canned  ->  کنسرو شده
capable  ->  توانا
capacity  ->  ظرفیت
capture  ->  گرفتن
carbon  ->  کربن
carbon dioxide  ->  دی اکسید کربن
carbon footprint  ->  رد پای کربن
carbon monoxide  ->  مونوکسید کربن
cardboard  ->  مقوا
cardigan  ->  ژاکت کش باف پشمی
carelessly  ->  بدون توجه
carelessness  ->  سهل انگاری - بی دقتی
caring  ->  مراقبت
carnival  ->  کارناوال
cast  ->  قالب
casually  ->  به طور اتفاقی
catalogue  ->  کاتالوگ
category  ->  دسته بندی
catering  ->  پذیرایی
cause  ->  علت
cautious  ->  محتاط
cease  ->  دست کشیدن
cell  ->  سلول
cellar  ->  انبار
cello  ->  ویولن سل
cemetery  ->  قبرستان
centigrade  ->  درجه سانتیگراد
certainty  ->  یقین - اطمینان - قطعیت
chaos  ->  آشوب
characteristic  ->  مشخصه
charm  ->  افسون
chart  ->  چارت سازمانی
chase  ->  تعقیب
cheat  ->  تقلب
cheeky  ->  پر رو
cheer  ->  تشویق کردن
cheerfully  ->  با خوشحالی
chemical  ->  شیمیایی
cherry  ->  گیلاس
chest  ->  قفسه سینه
chew  ->  جویدن
chief  ->  رئیس
childish  ->  کودکانه
chill  ->  سرد شدن
chimney  ->  دودکش
choir  ->  گروه کر
chop  ->  تکه کردن
circular  ->  گرد
circumstance  ->  چگونگی، امر، تفصیل، شرایط محیط، پیش امد، شرح
citizen  ->  شهروند
civilization (also civilisation)  ->  تمدن (همچنین تمدن)
claim  ->  مطالبه
classic  ->  کلاسیک
clause  ->  عبارت
client  ->  مشتری
climate change  ->  تغییرات آب و هوایی
closely  ->  به طرز نزدیک
cloth  ->  پارچه
clothing  ->  تن پوش
clue  ->  سرنخ
clumsy  ->  دست و پا چلفتی
coaching  ->  مربیگری
coastal  ->  ساحلی
code  ->  کد
coincidence  ->  اتفاقی
collapse  ->  سقوط - فروپاشی
collector  ->  گردآورنده
collocation  ->  همایند
colon  ->  روده بزرگ
column  ->  ستون
combination  ->  ترکیبی
combine  ->  ترکیب کردن
comedian  ->  کمدین
comfort  ->  راحتی
comfortably  ->  راحت
command  ->  فرمان
commerce  ->  تجارت
commercial  ->  تجاری
commit  ->  مرتکب شدن
commitment  ->  تعهد
committee  ->  کمیته
communicative  ->  ارتباطی
community  ->  انجمن
companion  ->  همراه و همدم
comparison  ->  مقایسه
competitive  ->  رقابتی
complex  ->  مجتمع
compose  ->  ساختن
composer  ->  آهنگساز
compromise  ->  به خطر افتادن
compulsory  ->  اجباری
concentration  ->  تمرکز
concept  ->  مفهوم
concern  ->  نگرانی
concerned  ->  نگران
concerning  ->  مربوط به
concrete  ->  بتن
conduct  ->  هدایت
conductor  ->  رهبر ارکستر
confess  ->  اعتراف کردن
confession  ->  اعتراف
confidence  ->  اعتماد به نفس
confidently  ->  با اطمینان
confirmation  ->  تائیدیه
conflict  ->  تعارض
confuse  ->  گیج کردن
confusion  ->  گیجی
congratulate  ->  تبریک گفتن
conjunction  ->  پیوستگی
conscious  ->  هوشیار، آگاه
consciousness  ->  آگاهی
consequence  ->  نتیجه
consequently  ->  در نتیجه
conservation  ->  حفاظت
considerable  ->  قابل توجه
considerably  ->  بطور قابل توجهی
consideration  ->  توجه
considering  ->  با توجه به
constant  ->  مقدار ثابت
constantly  ->  دائما
construct  ->  ساختن
construction  ->  ساخت و ساز
consultant  ->  مشاور
consume  ->  مصرف کردن
consumer  ->  مصرف كننده
container  ->  ظرف
contemporary  ->  امروزی
context  ->  متن نوشته
continuous  ->  مداوم
continuously  ->  به طور مداوم
contrary  ->  مخالف
contribute  ->  مشارکت
contribution  ->  مشارکت
controversial  ->  بحث برانگیز
convenience  ->  راحتی
conveniently  ->  به راحتی
conventional  ->  مرسوم
convert  ->  تبدیل
convinced  ->  متقاعد
cooperate (also co-operate)  ->  همکاری (همکاری)
cooperation (also co-operation)  ->  همکاری (همچنین همکاری)
cooperative  ->  تعاونی
cope  ->  کنار آمدن
copper  ->  فلز مس
corporation  ->  شرکت
correspond  ->  مطابقت
corridor  ->  راهرو
costume  ->  لباس
council  ->  شورا
counter  ->  پیشخوان
county  ->  شهرستان
courage  ->  شجاعت
courtesy  ->  حسن نیت
cowardly  ->  بزدل
crab  ->  خرچنگ
crack  ->  ترک
craft  ->  مهارت
crawl  ->  خزیدن
creation  ->  ایجاد
creatively  ->  خلاقانه
creativity  ->  خلاقیت
crisis  ->  بحران
critic  ->  منتقد
critical  ->  بحرانی
critically  ->  انتقادی
criticism  ->  انتقاد
criticize (also uk criticise)  ->  انتقاد کردن (همچنین انتقاد انگلستان)
crocodile  ->  تمساح
crossroads  ->  چهارراه
crucial  ->  حیاتی
cruelly  ->  بی رحمانه
cruelty  ->  ظلم و ستم
culturally  ->  بطور فرهنگی
cure  ->  درمان
curiosity  ->  کنجکاوی
current  ->  جاری
currently  ->  در حال حاضر
cursor  ->  مکان نما
curve  ->  منحنی
dairy  ->  لبنیات
damp  ->  مرطوب
dare  ->  جرات
darkness  ->  تاریکی
darling  ->  عزیز
dash  ->  خط تیره
data  ->  داده ها
database  ->  پایگاه داده
daughter-in-law  ->  عروس
dawn  ->  سپیده دم
daylight  ->  نور روز
daytime  ->  روز
deadline  ->  ضرب الاجل
deadly  ->  مرگبار
dealer  ->  فروشنده - دلال
debate  ->  مناظره
debit  ->  بدهی
debit card  ->  کارت اعتباری
debt  ->  بدهی
decade  ->  دهه
decay  ->  پوسیدگی
deceive  ->  فریب دادن
decent  ->  نجیب
decisive  ->  تعیین کننده
deck  ->  عرشه
decline  ->  کاهش می یابد
decoration  ->  تزیین
decorative  ->  تزئینی
deeply  ->  عمیقا
deer  ->  آهو
defender  ->  مدافع
define  ->  تعریف کردن
definite  ->  قطعی
definition  ->  تعریف
deliberate  ->  حساب شده
deliberately  ->  به عمد
delicate  ->  ظریف
delight  ->  لذت بسیار
delightful  ->  لذت بخش
demanding  ->  مطالبه گر
democracy  ->  دموکراسی
democratic  ->  دموکراتیک
demolish  ->  تخریب
demonstrate  ->  نشان دادن
demonstration  ->  تظاهرات
denim  ->  جین
dense  ->  متراکم
densely  ->  متراکم
dental  ->  دندانی
deny  ->  انکار
dependent  ->  وابسته
depressing  ->  افسرده کننده
depression  ->  افسردگی
deprive  ->  محروم کردن
descend  ->  فرود آمدن
desirable  ->  مطلوب
desire  ->  میل
desktop  ->  دسکتاپ
despair  ->  ناامیدی
desperate  ->  مستاصل
desperately  ->  ناامیدانه
destruction  ->  تخریب
detailed  ->  دقیق
determination  ->  عزم
determined  ->  مشخص
determiner  ->  تعیین کننده
developed  ->  توسعه یافته
developing  ->  در حال توسعه
device  ->  دستگاه
devil  ->  شیطان
devote  ->  اختصاص
devoted  ->  اختصاص داده شده است
dialogue  ->  گفتگو
diamond  ->  الماس
differ  ->  فرق داشتن
dilemma  ->  دوراهی
dip  ->  شیب
diplomat  ->  دیپلمات
disability  ->  ناتوانی
disagreement  ->  اختلاف نظر
disappearance  ->  ناپدید شدن
disapprove  ->  رد کردن
disaster  ->  فاجعه
discipline  ->  انضباط
discourage  ->  دلسرد کردن
discovery  ->  کشف
disgrace  ->  رسوایی
disguise  ->  مبدل کردن
dishonest  ->  متقلب
dishonesty  ->  بی صداقتی
disorganized (also uk disorganised)  ->  سازماندهی نشده (همچنین بریتانیا ناسازگار)
disposal  ->  دسترس
disrupt  ->  مختل کردن
dissatisfaction  ->  نارضایتی
dissatisfied  ->  ناراضی
distant  ->  غیر صمیمی
distinction  ->  فرق - تمیز - تشخیص
distinguish  ->  تمیز دادن
distinguished  ->  متمایز
distract  ->  حواس پرت کردن
distressing  ->  ناراحت کننده
distribute  ->  توزیع کردن
disturb  ->  مزاحم
diverse  ->  گوناگون، متنوع
divided  ->  تقسیم شده
division  ->  تقسیم
dizzy  ->  سرگیجه
domestic  ->  داخلی
dominate  ->  تسلط داشتن
donate  ->  اهدا کنند
donation  ->  اهداء
dose  ->  دوز
doubtful  ->  مشکوک
draft  ->  پیش نویس
dramatic  ->  نمایشی
dramatically  ->  به طور چشمگیری
dreadful  ->  وحشتناک
drown  ->  غرق شدن
drug  ->  دارو
drunk  ->  مست
dynamic  ->  پویا
eager  ->  مشتاق
eagerly  ->  مشتاقانه
eagerness  ->  اشتیاق
eagle  ->  عقاب
earnings  ->  درآمد
earthquake  ->  زمين لرزه
ease  ->  سهولت
ecological  ->  زیست محیطی
ecologically  ->  از نظر زیست محیطی
economic  ->  اقتصادی
economical  ->  مقرون به صرفه
economist  ->  اقتصاددان
economy  ->  اقتصاد
edit  ->  ویرایش کنید
edition  ->  ویرایش
editor  ->  ویرایشگر
educate  ->  آموزش
educated  ->  تحصیل کرده
educational  ->  آموزشی
effective  ->  تاثير گذار
effectively  ->  به طور موثر
efficiency  ->  بهره وری
efficiently  ->  به طور موثر
elect  ->  برگزیدن
electrician  ->  متخصص برق
electronically  ->  به صورت الکترونیکی
electronics  ->  الکترونیک
elegant  ->  ظریف
elegantly  ->  به زیبایی
element  ->  عنصر
elsewhere  ->  در جای دیگر
embarrassment  ->  خجالت
emerge  ->  ظهور
emotion  ->  هیجانی
emotional  ->  عاطفی
emotionally  ->  از نظر احساسی
emphasis  ->  تاکید
emphasize (also uk emphasise)  ->  تاکید (همچنین تاکید بریتانیا)
enable  ->  فعال کردن
enclose  ->  محصور کردن
encounter  ->  رویارویی
encouragement  ->  تشویق
encouraging  ->  دلگرم کننده
endangered  ->  در معرض خطر
endless  ->  بی پایان
endure  ->  تحمل کن
energetic  ->  پر انرژی
enjoyment  ->  لذت بردن
enquire (uk also inquire)  ->  پرس و جو (در انگلستان نیز پرس و جو کنید)
usalso insure)  ->  استفاده از بیمه)
entertainer  ->  سرگرم کننده
entertaining  ->  سرگرم کننده
enthusiasm  ->  اشتیاق
enthusiastic  ->  مشتاق
enthusiastically  ->  با اشتیاق
entire  ->  کل
entirely  ->  به طور کامل
entitle  ->  حق داشتن
environmentally  ->  از نظر محیطی
environmentally friendly  ->  سازگار با محیط زیست
envy  ->  حسادت
episode  ->  قسمت
equality  ->  برابری
equally  ->  به همان اندازه
equip  ->  تجهیز کردن
era  ->  عصر
error  ->  خطا
escalator  ->  پله برقی
establish  ->  تاسيس كردن
estate  ->  املاک
estimate  ->  تخمین زدن
estimated  ->  تخمین زده
eventually  ->  در نهایت
evidence  ->  شواهد و مدارک
evil  ->  بد
evolution  ->  سیر تکاملی
examine  ->  معاینه کردن
exception  ->  استثنا
exceptional  ->  استثنایی
exclamation mark  ->  علامت تعجب
exclusive  ->  انحصاری
exhausting  ->  طاقت فرسا
exhaustion  ->  فرسودگی
existence  ->  وجود داشتن
existing  ->  موجود
exotic  ->  خارجی
expand  ->  بسط دادن
expectation  ->  انتظار
expected  ->  انتظار می رود
expense  ->  هزینه
exploit  ->  بهره برداری
explosion  ->  انفجار
expose  ->  در معرض گذاشتن
express  ->  بیان
expression  ->  اصطلاح
extend  ->  توسعه دادن، گسترش
extensive  ->  گسترده
extent  ->  وسعت
external  ->  خارجی
extraordinarily  ->  فوق العاده
extreme  ->  مفرط
eyebrow  ->  ابرو
eyelash  ->  مژه
eyelid  ->  پلک
eyesight  ->  بینایی
facility  ->  امکانات
factor  ->  عامل
fade  ->  محو شدن
failure  ->  شکست
faint  ->  از هوش رفتن
faith  ->  ایمان
faithful  ->  با ایمان
faithfully  ->  صادقانه
fame  ->  شهرت
fantastically  ->  فوق العاده
fantasy  ->  فانتزی
fascinated  ->  مجذوب
fascinating  ->  شگفت انگیز
fatal  ->  کشنده
fate  ->  سرنوشت
father-in-law  ->  پدر شوهر
faulty  ->  معیوب
favourable  ->  مطلوب
feather  ->  پر
feature  ->  ویژگی
fed up  ->  خسته شده
feedback  ->  بازخورد
fellow  ->  همکار
fence  ->  حصار
fierce  ->  شدید
fighting  ->  زد و خورد
finance  ->  دارایی، مالیه، سرمایه گذاری
finely  ->  خوب
fingernail  ->  ناخن دست
fire brigade  ->  آتش نشانی
firmly  ->  محکم
first language  ->  زبان اول
firstly  ->  اولا
fisherman  ->  ماهیگیر
fixed  ->  درست شد
flame  ->  شعله
flash  ->  فلاش
flexibility  ->  انعطاف پذیری
flexible  ->  قابل انعطاف
fluency  ->  روانی
fluent  ->  روان، سلیس
fluently  ->  روان
focus  ->  تمرکز
foolish  ->  احمقانه
foolishly  ->  احمقانه
forbid  ->  منع
force  ->  زور
formal  ->  رسمی
formerly  ->  سابق
forthcoming  ->  آینده
fortunate  ->  خوش شانس
fortune  ->  ثروت
found  ->  یافت
fox  ->  روباه
frankly  ->  رک و پوست کنده
freedom  ->  آزادی
freely  ->  آزادانه
friendliness  ->  دوستی
frighten  ->  ترساندن
frost  ->  سرمازدگی
frustration  ->  نا امیدی
function  ->  عملکرد
functional  ->  کاربردی
funeral  ->  مراسم خاکسپاری
furious  ->  خشمگین
furiously  ->  با عصبانیت
furthermore  ->  علاوه بر این
gambling  ->  قمار
gang  ->  دسته
gardener  ->  باغبان
gardening  ->  باغبانی
gather  ->  جمع آوری
gaze  ->  خیره شدن
gear  ->  دنده
gender  ->  جنسیت
generate  ->  تولید می کنند
generosity  ->  سخاوت
generously  ->  سخاوتمندانه
genetics  ->  ژنتیک
gentleman  ->  جنتلمن
gently  ->  به آرامی
genuine  ->  اصل
genuinely  ->  واقعا
global  ->  جهانی است
globally  ->  در سطح جهانی
global warming  ->  گرم شدن کره زمین
google  ->  گوگل
gossip  ->  شایعات
govern  ->  حکومت کنند
gradual  ->  تدریجی
gradually  ->  به تدریج
graph  ->  نمودار
grave  ->  قبر
greatly  ->  تا حد زیادی
greatness  ->  عظمت
greedy  ->  طمع کار
grief  ->  غم و اندوه
grip  ->  گرفتن
growing  ->  در حال رشد
growth  ->  رشد
guarantee  ->  ضمانت
guidance  ->  راهنمایی
guilt  ->  گناه
gum  ->  آدامس
guts  ->  دل و روده
gymnastic  ->  ژیمناستیک
hammer  ->  چکش
handful  ->  تعداد انگشت شماری
handout  ->  جزوه
hard drive  ->  هارد دیسک
hard-working  ->  سخت کوش
harm  ->  صدمه
harmful  ->  زیان آور
harmless  ->  بی ضرر
harmony  ->  هارمونی
harvest  ->  محصول
haunt  ->  خالی از سکنه
headquarters  ->  مرکز فرماندهی
heal  ->  شفا دادن
heaven  ->  بهشت
hedge  ->  پرچین
hell  ->  جهنم
helmet  ->  کلاه ایمنی
helper  ->  یاور
hesitate  ->  تردید کنید
highlight  ->  برجسته
highly  ->  بسیار
high-tech  ->  با تکنولوژی بالا
hint  ->  اشاره
hip  ->  باسن
hi-tech  ->  فناوری پیشرفته
honesty  ->  صداقت
honour  ->  افتخار و احترام
hood  ->  کاپوت ماشین
hook  ->  قلاب
horn  ->  شیپور
host  ->  میزبان
hourly  ->  ساعتی
household  ->  خانواده
human rights  ->  حقوق بشر
hunting  ->  شکار
hyphen  ->  خط ربط
icon  ->  آیکون
ideal  ->  ایده آل
ideally  ->  در حالت ایده آل
identical  ->  همسان
identify  ->  شناسایی
identity  ->  هویت
idiom  ->  اصطلاح
idiot  ->  ادم سفیه و احمق
ignore  ->  چشم پوشی
illegal  ->  غیر مجاز
illegally  ->  به صورت غیر قانونی
illustrate  ->  نشان دادن
image  ->  تصویر
immediate  ->  فوری
immigrant  ->  مهاجر
immoral  ->  غیر اخلاقی
impact  ->  تأثیر
impatient  ->  بی صبر
impatiently  ->  بی صبرانه
imperative  ->  ضروری
implement  ->  پیاده سازی
impolite  ->  بی ادب
importantly  ->  مهم است
impress  ->  تاثیر گذاشتن
impressed  ->  تحت تاثیر قرار
impression  ->  احساس؛ عقیده؛ گمان
impressive  ->  چشمگیر
improved  ->  بهبود یافته
inaccurate  ->  نادرست
incident  ->  حادثه
income  ->  درآمد
inconvenient  ->  نامناسب
increasingly  ->  به طور فزاینده
incredibly  ->  بطور باور نکردنی
independence  ->  استقلال
independently  ->  به طور مستقل
indicate  ->  نشان می دهد
industrial  ->  صنعتی
inexperienced  ->  بی تجربه
infection  ->  عفونت
inflation  ->  تورم
influence  ->  نفوذ
informal  ->  دوستانه و غیر رسمی
inhabitant  ->  آنها ساکن هستند
initially  ->  در ابتدا
injured  ->  مجروح
injury  ->  صدمه
inner  ->  درونی
innocent  ->  بی گناه
innocently  ->  بی گناه
input  ->  ورودی
inquire (uk also enquire)  ->  پرس و جو (در انگلستان نیز پرس و جو کنید)
inspector  ->  بازرس
inspiration  ->  الهام گرفتن
inspire  ->  الهام بخشیدن
instant  ->  فوری
instantly  ->  فورا
institute  ->  موسسه
institution  ->  موسسه، نهاد
insurance  ->  بیمه
intellectual  ->  پر فکر
intelligence  ->  هوش
intensive  ->  متمرکز
interact  ->  تعامل داشتن
interactive  ->  در ارتباط بودن
interfere  ->  مداخله کردن
interior  ->  داخلی
internal  ->  درونی؛ داخلی
interpret  ->  تفسیر
interruption  ->  وقفه
introduction  ->  مقدمه
invade  ->  حمله کردن
invasion  ->  تهاجم
inventor  ->  مخترع
inverted commas  ->  کاماهای معکوس
invest  ->  سرمایه گذاری
investigate  ->  تحقیق کردن
investigation  ->  تحقیق و بررسی
investigator  ->  محقق
investment  ->  سرمایه گذاری
investor  ->  سرمایه گذار
invisible  ->  نامرئی
involved  ->  گرفتار
involvement  ->  درگیری
irresponsible  ->  بی مسئولیت
irritated  ->  تحریک شده
irritating  ->  آزار دهنده
itch  ->  خارش
jaw  ->  فک
jealously  ->  با حسادت
jewel  ->  جواهر
joint  ->  مفصل
journalism  ->  روزنامه نگاری
joy  ->  شادی
judgment (also judgement)  ->  قضاوت (همچنین قضاوت)
junior  ->  جوان
junk food  ->  غذای آشغال
jury  ->  هیئت داوران
justice  ->  عدالت
justify  ->  توجیه
kindness  ->  مهربانی
kingdom  ->  پادشاهی
kneel  ->  زانو زدن
landing  ->  فرود آمدن
landlady  ->  خانم صاحبخانه
landlord  ->  صاحب خانه
lane  ->  مسیر
lap  ->  دامان
largely  ->  تا حد زیادی
laser  ->  لیزر
lastly  ->  در آخر
last-minute  ->  آخرین لحظه
latter  ->  دومی
laughter  ->  خنده
launch  ->  راه اندازی
laundry  ->  خشکشویی
layer  ->  لایه
laziness  ->  تنبلی
leading  ->  منتهی شدن
leaflet  ->  جزوه
leak  ->  نشت
lean  ->  لاغر
learner  ->  یادگیرنده
learning  ->  یادگیری
lecturer  ->  مدرس
leek  ->  تره فرنگی
legal  ->  مجاز
legally  ->  به صورت قانونی
legend  ->  افسانه
leopard  ->  پلنگ
liar  ->  دروغ گو
liberty  ->  آزادی
lick  ->  لیسیدن
lid  ->  درب
lifestyle  ->  سبک زندگی
lifetime  ->  طول عمر
lighting  ->  روشنایی
literally  ->  به معنای واقعی کلمه
literary  ->  ادبی
litter  ->  آشغال
liver  ->  کبد
living  ->  زندگي كردن
loaf  ->  قرص نان
lobby  ->  لابی
log  ->  ورود به سیستم
logical  ->  منطقی
long-distance  ->  مسافت طولانی
long-term  ->  دراز مدت
long term  ->  دراز مدت
loss  ->  ضرر - زیان
lower  ->  پایین تر
loyal  ->  وفادار
loyalty  ->  وفاداری
lung  ->  ریه
lyrics  ->  متن ترانه
magical  ->  جادویی
maintain  ->  حفظ
maintenance  ->  نگهداری
major  ->  عمده
majority  ->  اکثریت
maker  ->  سازنده
management  ->  مدیریت
mankind  ->  بشر
manner  ->  شیوه
manual  ->  کتابچه راهنمای
manufacture  ->  ساخت
manufacturing  ->  تولید
marathon  ->  ماراتن
marketing  ->  بازار یابی
martial art  ->  هنر رزمی
mask  ->  ماسک
mass  ->  جرم
massive  ->  عظیم
master  ->  استاد
mathematical  ->  ریاضی
mature  ->  بالغ
mayor  ->  شهردار
meaningful  ->  معنی دار
means  ->  به معنای
meantime  ->  در ضمن
measure  ->  اندازه گرفتن
measurement  ->  اندازه گیری
mechanical  ->  مکانیکی
medal  ->  مدال
media  ->  رسانه ها
medical  ->  پزشکی
medieval (also mediaeval)  ->  قرون وسطایی (همچنین قرون وسطایی)
melt  ->  ذوب شدن
memorable  ->  بیاد ماندنی
mental  ->  ذهنی
mentally  ->  ذهنی
mere  ->  صرف
merely  ->  صرفا - فقط
microphone  ->  میکروفون
military  ->  نظامی
minister  ->  وزیر
minor  ->  جزئی
minority  ->  اقلیت
mint  ->  نعناع
miracle  ->  معجزه
misery  ->  بدبختی
misleading  ->  گمراه کننده
mission  ->  ماموریت
mist  ->  غبار
misty  ->  مه آلود
misunderstand  ->  سوء تفاهم
misunderstanding  ->  سوء تفاهم
mixture  ->  مخلوط
modest  ->  فروتن
monitor  ->  نظارت کنید
moonlight  ->  مهتاب
moral  ->  اخلاقی
morally  ->  از نظر اخلاقی
moreover  ->  علاوه بر این
mother-in-law  ->  مادر شوهر
motivated  ->  با انگیزه
motivation  ->  انگیزه
motive  ->  انگیزه
motor  ->  موتور
motorist  ->  راننده
movement  ->  جنبش
moving  ->  در حال حرکت
mud  ->  گل و لای
muddy  ->  گل آلود
mumble  ->  زمزمه کردن
muscle  ->  ماهیچه
mutter  ->  غرغر کردن
mysterious  ->  اسرار امیز
myth  ->  اسطوره
nail  ->  ناخن - میخ
naked  ->  برهنه
narrowly  ->  باریک
nation  ->  ملت
nationwide  ->  در سراسر کشور
native  ->  بومی
native speaker  ->  زبان مادری
naturally  ->  به طور طبیعی
naughty  ->  شیطون
navy  ->  نیروی دریایی
necessarily  ->  لزوما
needle  ->  سوزن
negatively  ->  منفی
neighbouring  ->  همسایه
neither  ->  هیچ کدام
nerves  ->  اعصاب
nervously  ->  عصبی
network  ->  شبکه
nevertheless  ->  با این اوصاف
newly  ->  به تازگی
nicely  ->  به خوبی
nod  ->  سر تکان دادن
nonsense  ->  مزخرف
non-smoking  ->  غیر سیگاری
nor  ->  نه
novelist  ->  رمان نویس
nuclear  ->  هسته ای
nuisance  ->  مزاحمت
nursery  ->  مهد کودک
nut  ->  مهره
oak  ->  بلوط
obey  ->  اطاعت کن
objection  ->  اعتراض
objective  ->  هدف، واقعگرایانه
obligation  ->  تعهد
oblige  ->  وادار کردن
observation  ->  مشاهده
observe  ->  رعایت کنید
obsessed  ->  غرق
obsession  ->  وسواس
occasionally  ->  گاه و بیگاه
occupy  ->  را اشغال کند
occur  ->  روی دادن
odd  ->  فرد
offence  ->  توهین
offend  ->  توهین کردن
offender  ->  مجرم
offensive  ->  توهین آمیز
official  ->  رسمی
i only hope (that) ...  ->  من فقط امیدوارم (که) ...
opening  ->  افتتاح
operator  ->  اپراتور
opponent  ->  حریف
oppose  ->  مخالفت کنند
optimistic  ->  خوشبین
optional  ->  اختیاری
oral  ->  دهانی
orchestral  ->  ارکسترال
organic  ->  ارگانیک. آلی
organized (also uk organised)  ->  سازمان یافته (همچنین سازماندهی شده در بریتانیا)
organizer (also uk organiser)  ->  سازمان دهنده (همچنین برگزار کننده بریتانیا)
origin  ->  اصل و نسب
originally  ->  در اصل
outer  ->  بیرونی
outline  ->  طرح کلی
outrageous  ->  ظالمانه
outskirts  ->  حومه
outstanding  ->  برجسته
oval  ->  بیضی شکل
overall  ->  به طور کلی
overcome  ->  غلبه بر
overlook  ->  نادیده گرفتن
overseas  ->  خارج از کشور
overtake  ->  سبقت گرفتن
overtime  ->  در طول زمان
overweight  ->  اضافه وزن
owing to  ->  به دلیل
owl  ->  جغد
oxygen  ->  اکسیژن
pace  ->  سرعت
package  ->  بسته بندی
packed  ->  بسته بندی شده
pancake  ->  پنکیک
panic  ->  وحشت
paperwork  ->  کاغذبازی
parachute  ->  چتر نجات
parade  ->  رژه
parliament  ->  مجلس
partial  ->  جزئي
participate  ->  شرکت کردن
partnership  ->  شراکت
passage  ->  گذر
passion  ->  شور
passionate  ->  پرشور
passionately  ->  پرشور
patience  ->  صبر
patiently  ->  صبورانه
paw  ->  پنجه
payment  ->  پرداخت
peacefully  ->  به صورت مسالمت آمیز
peculiar  ->  عجیب و غریب
pedal  ->  پدال
peel  ->  پوست کندن
penalty  ->  پنالتی
pension  ->  حقوق بازنشستگی
percentage  ->  درصد
permanently  ->  به طور دائم
personality  ->  شخصیت
pessimistic  ->  بدبین
petrified  ->  متحجر شده
pharmacist  ->  داروساز
phase  ->  فاز
philosopher  ->  فیلسوف
philosophy  ->  فلسفه
physical  ->  فیزیکی
physically  ->  از نظر فیزیکی
picturesque  ->  زیبا
pine  ->  کاج
pint  ->  پینت
pitch  ->  گام صدا
planning  ->  برنامه ریزی
plot  ->  طرح
plumber  ->  لوله کش
point of view  ->  نقطه نظر
poison  ->  سم
poisonous  ->  سمی
polar bear  ->  خرس قطبی
policy  ->  خط مشی
politeness  ->  ادب
pollute  ->  آلوده کردن
pond  ->  حوضچه
popularity  ->  محبوبیت
portion  ->  بخش
portrait  ->  پرتره
posh  ->  شیک
positively  ->  مثبت
possession  ->  مالکیت
pottery  ->  کوزه گری
poverty  ->  فقر
powerfully  ->  با قدرت
practical  ->  کاربردی
practically  ->  عملا
praise  ->  ستایش
prawn  ->  میگو
precious  ->  گرانبها
precise  ->  دقیق
precisely  ->  دقیقا
predictable  ->  قابل پیش بینی
prediction  ->  پیش بینی
preferable  ->  ارجح است
preferably  ->  ترجیحا
preference  ->  ترجیح
prefix  ->  پیشوند
prejudice  ->  تعصب
presence  ->  حضور
presenter  ->  ارائه کننده
preserve  ->  حفظ
presidency  ->  ریاست جمهوری
presidential  ->  ریاست جمهوری
pressure  ->  فشار
presumably  ->  احتمالا
pretend  ->  تظاهر کن
prevention  ->  جلوگیری
priceless  ->  بسیار گرانبها
pride  ->  غرور
primarily  ->  در درجه اول
primary  ->  اولیه
prime minister  ->  نخست وزیر
priority  ->  اولویت
privacy  ->  حریم خصوصی
privately  ->  به صورت خصوصی
pro  ->  حرفه ای
probable  ->  محتمل
procedure  ->  روش
process  ->  روند
producer  ->  تهیه کننده
production  ->  تولید
productive  ->  سازنده
profile  ->  مشخصات
profit  ->  سود
profitable  ->  سودآور
programming  ->  برنامه نويسي
progressive  ->  ترقی خواه
prohibit  ->  ممنوع کرده است
promotion  ->  ترویج
prompt  ->  سریع
promptly  ->  بی درنگ
proof  ->  اثبات
proper noun  ->  اسم خاص
proposal  ->  پیشنهاد
propose  ->  پیشنهاد کند
proposed  ->  پیشنهاد شده
prospect  ->  چشم انداز
protection  ->  حفاظت
protective  ->  محافظ
protest  ->  اعتراض
proudly  ->  با افتخار
provided (that)  ->  به شرطی که)
psychological  ->  روانشناسی
psychologically  ->  از نظر روانی
psychologist  ->  روانشناس
psychology  ->  روانشناسی
publication  ->  انتشار
publicity  ->  تبلیغات
publisher  ->  ناشر
pudding  ->  پودینگ
punch  ->  مشت زدن
punishment  ->  مجازات
puzzled  ->  متحیر شده
pyjamas  ->  لباس خواب
qualify  ->  واجد شرایط شدن
quarrel  ->  نزاع
query  ->  پرس و جو
racial  ->  نژادی
racism  ->  نژاد پرستی
rage  ->  خشم
rainbow  ->  رنگین کمان
rape  ->  تجاوز جنسی
rapid  ->  سریع
rapidly  ->  به طور سریع
rate  ->  نرخ
ray  ->  اشعه
razor  ->  تیغ
react  ->  واکنش نشان دهند
reaction  ->  واکنش
readily  ->  به راحتی
reality  ->  واقعیت
rear  ->  عقب
rearrange  ->  تنظیم مجدد
recall  ->  به خاطر آوردن
recession  ->  رکود اقتصادی
reckon  ->  حساب کنید
recommendation  ->  توصیه
recovery  ->  بهبود
recreation  ->  تفریحی
rectangular  ->  مستطیل شکل
reduction  ->  کاهش
redundant  ->  زائد
refer  ->  مراجعه کنید
referee  ->  داور
reference  ->  مرجع
reflect  ->  منعکس کنند
reflection  ->  بازتاب
refugee  ->  پناهنده
regain  ->  به دست آوردن مجدد
regional  ->  منطقه ای
regulation  ->  مقررات
rehearsal  ->  مشق
reject  ->  رد کردن
related  ->  مربوط
relatively  ->  به طور نسبی
release  ->  رهایی
relevant  ->  مربوط
relief  ->  تسکین
relieved  ->  راحت شد
religious  ->  دینی
rely  ->  تکیه
remaining  ->  باقی مانده است
remains  ->  باقی
remark  ->  تذکر
remarkable  ->  قابل توجه
remedy  ->  درمان
remote  ->  از راه دور
renew  ->  تجدید
repay  ->  بازپرداخت
replacement  ->  جایگزینی
represent  ->  نمایندگی کند
representative  ->  نماینده
reputation  ->  شهرت، آبرو
requirement  ->  نیاز
researcher  ->  محقق
resident  ->  مقیم
resign  ->  استعفا دهد
resist  ->  مقاومت کردن
resource  ->  منبع
respectable  ->  قابل احترام
respected  ->  احترام
respond  ->  پاسخ دادن
response  ->  واکنش
responsibility  ->  مسئولیت
restore  ->  بازگرداندن
retired  ->  بازنشسته
retirement  ->  بازنشستگی
reveal  ->  آشکار کردن
revenge  ->  انتقام گرفتن
reverse  ->  معکوس
revolution  ->  انقلاب
revolutionary  ->  انقلابی
rewrite  ->  بازنویسی
rhythm  ->  ریتم
rib  ->  دنده
ridiculous  ->  مسخره - مضحک
rightly  ->  به درستی
rip  ->  پاره کردن
ripe  ->  رسیده
risk  ->  خطر
risky  ->  مخاطره آمیز
robbery  ->  سرقت
rocket  ->  موشک
roommate  ->  هم اتاقی
root  ->  ریشه
rope  ->  طناب
rotten  ->  پوسیده
roughly  ->  تقریبا
row2  ->  ردیف 2
royal  ->  سلطنتی
rub  ->  مالیدن
rumour  ->  شایعه
rural  ->  روستایی
rush  ->  هجوم بردن
rush hour  ->  ساعت شلوغی
rusty  ->  زنگ زده
sack  ->  گونی
sadly  ->  با ناراحتی
sadness  ->  غمگینی
safety  ->  ایمنی
sake  ->  منظور
salon  ->  سالن
salty  ->  شور
sample  ->  نمونه
satellite  ->  ماهواره
satisfaction  ->  رضایت
satisfactory  ->  رضایتبخش
satisfy  ->  راضی کردن
savings  ->  پس انداز
scale  ->  مقیاس
scandal  ->  رسوایی
scar  ->  جای زخم
scent  ->  رایحه
schedule  ->  برنامه
scheduled  ->  برنامه ریزی شده است
scheme  ->  طرح
scientifically  ->  علمی
scratch  ->  خراش
script  ->  اسکریپت
seal  ->  مهر
seasonal  ->  فصلی
secondly  ->  دوما
secure  ->  امن است
seed  ->  دانه
seek  ->  به دنبال
seize  ->  تصاحب کردن
seldom  ->  به ندرت
selection  ->  انتخاب
self-confidence  ->  اعتماد به نفس
self-confident  ->  با اعتماد به نفس
semicolon  ->  نقطه ویرگول
semi-final  ->  نیمه نهایی
seminar  ->  سمینار
senior  ->  ارشد
sensation  ->  احساس
sensitive  ->  حساس
separately  ->  بطور جداگانه
separation  ->  جدایش، جدایی
servant  ->  خدمتگزار
setting  ->  تنظیمات
settle  ->  حل کن
severe  ->  شدید
severely  ->  به شدت، شدیدا
sexual  ->  جنسی
sexy  ->  سکسی
shallow  ->  کم عمق
sharply  ->  به شدت
shed  ->  دهنه
shell  ->  پوسته
shelter  ->  پناه
shift  ->  تغییر مکان
shiver  ->  لرزیدن
shooting  ->  تیراندازی کردن
shopkeeper  ->  مغازه دار
shortage  ->  کمبود
short-term  ->  کوتاه مدت
short term  ->  کوتاه مدت
shot  ->  شلیک کرد
shrink  ->  کوچک شدن
sickness  ->  بیماری
sigh  ->  آه
signal  ->  علامت
significant  ->  قابل توجه
significantly  ->  به طور قابل ملاحظه
silently  ->  بی صدا
similarity  ->  شباهت
simply  ->  به سادگی
simultaneously  ->  همزمان
sister-in-law  ->  خواهر شوهر
skeleton  ->  اسکلت
skilful  ->  ماهر
skilled  ->  ماهر
skip  ->  جست و خیز کردن
slam  ->  ضربه زدن
slap  ->  سیلی زدن
slash  ->  بریده بریده
slave  ->  برده
slide  ->  اسلاید
slight  ->  اندک
slightly  ->  اندکی
slope  ->  شیب
smash  ->  درهم کوبیدن
smoker  ->  سیگاری
smoothly  ->  به نرمی
sneeze  ->  عطسه
snore  ->  خروپف کردن
soak  ->  خیس خوردن
soaked  ->  خیس شده
soaking  ->  خیساندن
sob  ->  گریه کردن
so-called  ->  باصطلاح
socialize (also uk socialise)  ->  معاشرت کردن (همچنین در بریتانیا معاشرت کردن)
softness  ->  نرمی
soil  ->  خاک
solar  ->  خورشیدی
solid  ->  جامد
solo  ->  انفرادی
son-in-law  ->  داماد
sophisticated  ->  پیچیده
soundtrack  ->  موسیقی متن
source  ->  منبع
specialist  ->  متخصص
specialize (also uk specialise)  ->  تخصص (همچنین تخصص انگلستان)
species  ->  گونه ها
specific  ->  خاص
specify  ->  مشخص نمودن
spectator  ->  تماشاگر
spirit  ->  روح
spiritual  ->  معنوی
splash  ->  پاشیدن
sponsor  ->  حامی
spray  ->  افشانه
spread  ->  انتشار دادن
spreadsheet  ->  صفحه گسترده
squeeze  ->  چلاندن، فشار دادن
stab  ->  چاقو زدن
stain  ->  لکه دار کردن
standard  ->  استاندارد
stare  ->  خیره شدن
starving  ->  گرسنگی
state  ->  حالت
statement  ->  بیانیه
statistics  ->  آمار
steadily  ->  به طور پیوسته
steady  ->  ثابت
steam  ->  بخار
steel  ->  فولاد
steer  ->  هدایت کردن
steering wheel  ->  فرمان
stepfather  ->  پدر خوانده
stepmother  ->  مادر خوانده
stiff  ->  سفت
stimulate  ->  تحریک
stock  ->  موجودی
stool  ->  مدفوع
stopover  ->  توقف
storage  ->  ذخیره سازی
storey  ->  طبقه
stormy  ->  طوفانی
straightforward  ->  سرراست
strain  ->  نژاد
strangely  ->  به طرز عجیبی
strategy  ->  استراتژی
strength  ->  استحکام - قدرت
strengthen  ->  تقویت
stretch  ->  کش آمدن
strictly  ->  موکدا
striking  ->  قابل توجه، برجسته، موثر
string  ->  رشته
stroke  ->  سکته
strongly  ->  به شدت
structure  ->  ساختار
struggle  ->  تقلا
stubborn  ->  یک دنده
stuck  ->  گیر
stunning  ->  خیره کننده
submit  ->  ارسال
substance  ->  ماده
substantial  ->  قابل توجه
substitute  ->  جایگزین
suburb  ->  حومه شهر
subway  ->  مترو
successfully  ->  با موفقیت
sudden  ->  ناگهانی
suffering  ->  رنج کشیدن
sufficient  ->  کافی
suffix  ->  پسوند
suicide  ->  خودکشی کردن
suitably  ->  مناسب
summary  ->  خلاصه
sunlight  ->  نور خورشید
superb  ->  عالی
supernatural  ->  فراطبیعی
supervise  ->  نظارت
supplier  ->  تامین کننده
supply  ->  عرضه
surely  ->  مسلما
surface  ->  سطح
surgery  ->  عمل جراحي
surrounding  ->  اطراف
surroundings  ->  محیط اطراف
survey  ->  نظر سنجی
survival  ->  بقا
survive  ->  زنده ماندن
survivor  ->  بازمانده
suspect  ->  مشکوک
suspend  ->  تعلیق کند
suspicion  ->  سوء ظن
suspicious  ->  مشکوک
suspiciously  ->  به طرز مشکوکی
swallow  ->  بلع
swan  ->  قو
swear  ->  سوگند
sweat  ->  عرق
sweep  ->  جارو کردن
swing  ->  تاب خوردن
swollen  ->  متورم شدن
sword  ->  شمشیر
syllable  ->  هجا
symbol  ->  نماد
sympathetic  ->  دلسوز
sympathy  ->  ابراز همدردی
symptom  ->  علامت
tabloid  ->  تبلوید
tackle  ->  برخورد با
tail  ->  دم
tale  ->  داستان
tan  ->  برنزه
target  ->  هدف
task  ->  وظیفه
tease  ->  اذیت کردن
teaspoon  ->  قاشق چایخوری
technical  ->  فنی
technological  ->  تکنولوژیکی
telecommunications  ->  مخابرات
telescope  ->  تلسکوپ
temper  ->  خلق و خوی
temporarily  ->  به طور موقت
tempt  ->  دچار وسوسه کردن
temptation  ->  وسوسه
tend  ->  تمایل
tension  ->  تنش
terminal  ->  پایانه
terms  ->  مقررات
terrace  ->  تراس
terrify  ->  وحشتناک کردن
terrifying  ->  وحشتناک
territory  ->  قلمرو
terror  ->  وحشت
terrorism  ->  تروریسم
terrorist  ->  تروریست
the first person  ->  نفر اول
theft  ->  سرقت
the last minute  ->  آخرین لحظه
theme  ->  موضوع
theory  ->  تئوری
therapy  ->  درمان
thermometer  ->  دماسنج
the second person  ->  نفر دوم
thesis  ->  پایان نامه
the third person  ->  نفر سوم
thigh  ->  ران
thirst  ->  تشنگی
thorough  ->  کامل
thoroughly  ->  به طور کامل
thoughtful  ->  متفکر
threat  ->  تهدید
threaten  ->  تهدید کند
thrilled  ->  هیجان زده
thrilling  ->  هیجان انگیز
throughout  ->  در سراسر
tide  ->  جزر و مد
tighten  ->  سفت کردن
tightly  ->  محکم
times  ->  بار
timing  ->  زمان سنجی
tiredness  ->  خستگی
toenail  ->  ناخن پا
tolerate  ->  تحمل كردن
tomb  ->  مقبره
ton  ->  تن
tone  ->  لحن
tool  ->  ابزار
torch  ->  مشعل
tornado  ->  گردباد
tough  ->  سخت است
toxic  ->  سمی
trace  ->  پی گیری
tradition  ->  سنت
traditionally  ->  به طور سنتی
tragedy  ->  تراژدی
tragic  ->  غم انگیز
trail  ->  دنباله
transform  ->  تبدیل
transparent  ->  شفاف
trap  ->  تله
tray  ->  سینی
treasure  ->  گنج
treat  ->  درمان شود
treatment  ->  رفتار
trekking  ->  پیاده روی
tremble  ->  لرزیدن
tremendous  ->  عظیم
tremendously  ->  فوق العاده
trial  ->  آزمایش
triangle  ->  مثلث
tribe  ->  قبیله
tricky  ->  روی حیله و تزویر
trivial  ->  ناچیز
trolley  ->  چرخ دستی
trophy  ->  جام
tropical  ->  گرمسیری
trunk  ->  تنه
tutor  ->  معلم خصوصی
twisted  ->  پیچ خورده
ultimate  ->  نهایی
unacceptable  ->  غیر قابل قبول
unattractive  ->  غیر جذاب
unavailable  ->  غیر قابل دسترسی
unaware  ->  غافل
unbearable  ->  غیر قابل تحمل
uncertain  ->  نا معلوم
unchanged  ->  بدون تغییر
unclear  ->  غیر واضح
unconscious  ->  ناخودآگاه
underestimate  ->  دست کم گرفتن
adjective; adverb  ->  صفت قید
underground2  ->  زیرزمینی 2
understandable  ->  قابل درک
understanding  ->  فهم
underwater  ->  زیر آب
undo  ->  لغو کردن
undoubtedly  ->  بی شک
undressed  ->  برهنه
uneasy  ->  ناآرام
unexpectedly  ->  بر خلاف انتظار
unfairly  ->  ناعادلانه
unfamiliar  ->  نا آشنا
unfashionable  ->  غیر مد
unfortunate  ->  مایه تاسف
unhappiness  ->  ناراحتی
unhelpful  ->  بی فایده
unique  ->  منحصر بفرد
united  ->  متحد
universal  ->  جهانی
unlike  ->  بر خلاف
unlimited  ->  نامحدود
unlock  ->  باز کردن قفل
unnatural  ->  غیر طبیعی
unpopular  ->  غیر محبوب
unpredictable  ->  غیر قابل پیش بینی
unrealistic  ->  غیر واقعی
unreasonable  ->  غیر منطقی
unreliable  ->  غیر قابل اعتماد
unsatisfactory  ->  نامطلوب
unsuccessful  ->  ناموفق
unsuitable  ->  نامناسب
unsure  ->  نامطمئن
untie  ->  باز کردن
unusually  ->  غیرعادی
unwilling  ->  ناخواسته، بی میل
upbringing  ->  تربیت
upright  ->  عمودی
upside down  ->  وارونه
urban  ->  شهری
vacant  ->  خالی
valid  ->  معتبر
vanish  ->  ناپدید شدن
variation  ->  تغییر
varied  ->  متنوع
vary  ->  متفاوت
vast  ->  وسیع
venue  ->  محل
verse  ->  آیه
version  ->  نسخه
victim  ->  قربانی
victory  ->  پیروزی
viewer  ->  بیننده
vinegar  ->  سرکه
violence  ->  خشونت
violent  ->  خشن
violently  ->  با خشونت
virtual  ->  مجازی
virtually  ->  به صورت مجازی
virtual reality  ->  واقعیت مجازی
visible  ->  قابل رویت
vision  ->  چشم انداز
visual  ->  دیداری
vital  ->  حیاتی
vitamin  ->  ویتامین
vivid  ->  واضح
vividly  ->  به وضوح
volcano  ->  آتشفشان
volunteer  ->  داوطلب
voyage  ->  سفر دریایی
waist  ->  کمر
wander  ->  پرسه زدن
ward  ->  بخش
warmly  ->  به گرمی
warmth  ->  گرما
wasp  ->  زنبور
waterproof  ->  ضدآب
weakness  ->  ضعف
wealth  ->  ثروت
wealthy  ->  ثروتمند
weapon  ->  سلاح
weird  ->  عجیب و غریب
welfare  ->  رفاه
well-balanced  ->  متعادل
well-built  ->  به خوبی ساخته شده
well-organized (also uk well-organised)  ->  به خوبی سازماندهی شده (همچنین بریتانیا به خوبی سازماندهی شده)
well-paid  ->  پرداخت خوب
wheat  ->  گندم
whereas  ->  در حالیکه
whichever  ->  هر کدام
whisky  ->  ویسکی
whisper  ->  نجوا
whistle  ->  سوت زدن
whoever  ->  هر کسی که
whom  ->  چه کسی
widely  ->  به طور گسترده ای
widen  ->  گسترده شود
widow  ->  بیوه
width  ->  عرض
wildly  ->  وحشیانه
willingly  ->  با کمال میل
willingness  ->  تمایل
wind2  ->  باد 2
winding  ->  سیم پیچی
wipe  ->  پاک کن
wire  ->  سیم
wisdom  ->  خرد
wise  ->  عاقل
witness  ->  شاهد
witty  ->  شوخ
wolf  ->  گرگ
worldwide  ->  در سراسر جهان
worm  ->  کرم
worrying  ->  نگران کننده
worthwhile  ->  با ارزش
wound  ->  زخم
wrist  ->  مچ دست
wrongly  ->  به اشتباه
x-ray  ->  اشعه ایکس
yacht  ->  قایق بادبانی
yawn  ->  خمیازه
yell  ->  فریاد زدن
zebra  ->  گورخر
zip  ->  زیپ

C1
--
abnormal  ->  غیرطبیعی
aboard  ->  در کشتی
abortion  ->  سقط جنین
accelerate  ->  سرعت بخشیدن
acceptance  ->  پذیرش - پذیرفته شدن
accepted  ->  پذیرفته شده
accessory  ->  لوازم جانبی
acclaimed  ->  تحسین شده
accomplish  ->  انجام دهد
accordance  ->  مطابقت
accumulate  ->  انباشتن
accusation  ->  اتهام
accustomed  ->  عادت کرده
acknowledge  ->  اذعان
acquaintance  ->  آشنایی
adaptation  ->  انطباق
addictive  ->  اعتیاد آور
administration  ->  مدیریت
administrative  ->  اداری
administrator  ->  مدیر
adviser  ->  مشاور
affluent  ->  فراوان
affordable  ->  مقرون به صرفه
agenda  ->  دستور جلسه
aggression  ->  پرخاشگری
aid  ->  کمک
alarming  ->  هشدار دهنده
alert  ->  هشدار
allegation  ->  ادعا
alleged  ->  ادعا شده است
allocate  ->  اختصاص دهد
allowance  ->  کمک هزینه
ally  ->  متحد
alongside  ->  در کنار
alteration  ->  تغییر
amateur  ->  آماتور
amendment  ->  اصلاحیه
amid  ->  در میان
ample  ->  کافی
analytical  ->  تحلیلی
angle  ->  زاویه
annoyance  ->  مزاحمت
anticipate  ->  پیش بینی کنید
anti-social  ->  ضد اجتماعی
appalling  ->  مخوف
appetite  ->  اشتها، میل
applaud  ->  کف زدن
applause  ->  تشویق و تمجید
appliance  ->  دستگاه
appoint  ->  تعیین کنید
archaeologist  ->  باستان شناس
archaeology  ->  باستان شناسی
arise  ->  بوجود امدن
assert  ->  ادعا کردن
asset  ->  دارایی
assign  ->  اختصاص دهد
assignment  ->  وظیفه
assumption  ->  فرض
assurance  ->  اطمینان
attain  ->  حداقل
attendance  ->  حضور
auction  ->  حراج
audition  ->  آزمون
authentic  ->  معتبر
authorize  ->  اجازه دهد
avenue  ->  خیابان
awareness  ->  اطلاع
bacteria  ->  باکتری ها
bankrupt  ->  ورشکسته
beak  ->  منقار
beware  ->  برحذر بودن
biased  ->  جانبدارانه
bid  ->  پیشنهاد
bilingual  ->  دو زبانه
blindness  ->  کوری
boundary  ->  مرز
brass  ->  برنجی
bribe  ->  رشوه دادن
broaden  ->  گسترش دهد
broadly  ->  به طور گسترده
bronze  ->  برنز
brutal  ->  وحشیانه
bubble  ->  حباب
bulk  ->  فله
bulky  ->  حجیم
bully  ->  گردن کلفت
burden  ->  بار
campaign  ->  پویش
cancellation  ->  لغو
capability  ->  قابلیت
carriage  ->  کالسکه
cater  ->  تهیه غذا
caution  ->  احتیاط
changeable  ->  تغییر پذیر
chaotic  ->  بی نظم
chatty  ->  پرحرف
chilly  ->  سرد
cholesterol  ->  کلسترول
chore  ->  کارهای عادی و روزمره
civil  ->  مدنی
clarification  ->  شفاف سازی
clarify  ->  روشن کردن
classify  ->  طبقه بندی کردن
clinical  ->  بالینی
closeness  ->  نزدیکی
clutch  ->  کلاچ
coal  ->  زغال سنگ
collaborate  ->  همکاری
collaboration  ->  همکاری
commodity  ->  کالا
commonly  ->  معمولا
commute  ->  رفت و آمد
comparable  ->  قابل مقایسه
comparatively  ->  به صورت مقایسه ای
compatible  ->  سازگار
compel  ->  مجبور کردن
compensate  ->  جبران کردن
competence  ->  صلاحیت
competent  ->  صالح
compile  ->  گردآوری
completion  ->  تکمیل
complicate  ->  پیچیده کردن
complication  ->  عوارض
comply  ->  رعایت کنند
component  ->  جزء
comprehensive  ->  همه جانبه
comprehensively  ->  به طور جامع
comprise  ->  شامل می شود
conclude  ->  نتیجه گرفتن
confidential  ->  محرمانه
congestion  ->  تراکم، شلوغی
conquer  ->  تسخیر
conscientious  ->  با وجدان
consent  ->  رضایت
conservative  ->  محافظه کار
considerate  ->  با ملاحظه
constitute  ->  تشکیل می دهند
constitution  ->  قانون اساسي
constructive  ->  سازنده
consult  ->  مشورت کردن
consumption  ->  مصرف
contestant  ->  شرکت کننده
continual  ->  مستمر
continually  ->  به طور پیوسته
contradict  ->  تناقض دارند
controversy  ->  جنجال - جدال سرسختانه
convention  ->  قرارداد
convey  ->  انتقال
convincing  ->  متقاعد کننده
coolness  ->  خنکی
corporate  ->  شرکت های بزرگ، دارای شخصیت حقوقی
corrupt  ->  فاسد
corruption  ->  فساد
cosmopolitan  ->  شهری
counterpart  ->  همتا
countless  ->  بی شمار
courageous  ->  شجاع
coverage  ->  پوشش
criterion  ->  معیار
crystal  ->  کریستال
cultivate  ->  کشت کنند
cultivation  ->  کشت
customary  ->  مرسوم
cutback  ->  کاهش
cutting-edge  ->  لبه برش
daycare  ->  مهد کودک
daydream  ->  رویاپردازی
day-to-day  ->  روز به روز
debut  ->  شروع کردن - آغاز - اولین
declaration  ->  اعلام
dedicate  ->  وقف کن
dedicated  ->  اختصاصی
dedication  ->  فداکاری
deduction  ->  کسر
deepen  ->  عمیق تر کردن
defect  ->  کاستی
deficiency  ->  کمبود
deficit  ->  کمبود
density  ->  تراکم
deodorant  ->  دئودورانت
deprived  ->  محروم شده است
deputy  ->  قائم مقام
derive  ->  استخراج
deserted  ->  متروک
destiny  ->  سرنوشت
detached  ->  جدا
detect  ->  تشخیص
deteriorate  ->  بدتر شدن
determine  ->  تعیین کنید
devastated  ->  ویران
devastating  ->  ویرانگر
developer  ->  توسعه دهنده
dictate  ->  دیکته کردن
diesel  ->  دیزل
differentiate  ->  متمایز کردن
digest  ->  هضم
digestion  ->  گوارش
diminish  ->  کاهش
diplomatic  ->  دیپلماتیک
directory  ->  فهرست راهنما
disadvantaged  ->  محروم
disapproval  ->  عدم تایید
disastrous  ->  فاجعه بار
discomfort  ->  درد و ناراحتی
discontent  ->  نارضایتی
discriminate  ->  تبعیض قائل شدن
discrimination  ->  تبعیض
disgusted  ->  منزجر
dishonestly  ->  ناصادقانه
dismiss  ->  رد
dismissal  ->  اخراج
disorder  ->  بی نظمی
displace  ->  جابجا کند
displacement  ->  جابه جایی
dispose  ->  در معرض قرار دادن
disrespect  ->  بی احترامی
disruption  ->  قطع
dissertation  ->  پایان نامه
dissolve  ->  حل کردن
distinct  ->  متمایز
distinctive  ->  متمایز
distort  ->  تحریف کردن
distraction  ->  حواس پرتی
distress  ->  پریشانی
distressed  ->  پریشان
distribution  ->  توزیع
disturbance  ->  اختلال
diversity  ->  تنوع
divert  ->  منحرف کردن
dock  ->  بارانداز
domain  ->  دامنه
dominant  ->  غالب
domination  ->  سلطه
downside  ->  منفی
down-to-earth  ->  سر به زمین
downward  ->  رو به پایین
downwards  ->  به سمت پایین
drastic  ->  شدید
drastically  ->  به شدت
draught  ->  پیش نویس
drawback  ->  اشکال
dual  ->  دوگانه
dumb  ->  بی عقل
dump  ->  زباله
duration  ->  مدت زمان
dwell  ->  ساکن
ecology  ->  بوم شناسی
edible  ->  خوراکی
effectiveness  ->  اثربخشی
elegance  ->  ظرافت
eligible  ->  واجد شرایط
eliminate  ->  از بین بردن
elite  ->  نخبه
embrace  ->  پذیرفتن
emission  ->  انتشار
emperor  ->  امپراتور
empire  ->  امپراتوری
endeavour  ->  تلاش
enforce  ->  اجرا کنند
engage  ->  مشغول کردن
enhance  ->  افزایش دهد
enrich  ->  غنی سازی
enterprise  ->  شرکت، پروژه
environmentalist  ->  طرفدار محیط زیست
envisage  ->  پیش بینی
envision  ->  تجسم
equation  ->  معادله
equivalent  ->  معادل
erosion  ->  فرسایش
establishment  ->  استقرار
ethnic  ->  قومی
evaluate  ->  ارزیابی کنید
evaluation  ->  ارزیابی
evolve  ->  تکامل یابد
exaggerate  ->  اغراق کردن، مبالغه
exaggeration  ->  اغراق
exceed  ->  تجاوز
exceptionally  ->  استثنایی
excessive  ->  بیش از اندازه
exclude  ->  حذف کنند
exclusively  ->  منحصرا
executive  ->  اجرایی
exhaust  ->  اگزوز
exhaustive  ->  جامع
exhibit  ->  نمایشگاه
expenses  ->  هزینه ها
exploration  ->  اکتشاف
exposure  ->  قرارگیری در معرض
exterior  ->  خارجی
extinct  ->  منقرض شده
extinction  ->  انقراض
extrovert  ->  برون گرا
fabric  ->  پارچه
fabulous  ->  شگفت آور
facilitate  ->  تسهیل کردن
faculty  ->  دانشکده
fairness  ->  انصاف
fake  ->  جعلی
fascinate  ->  مجذوب کردن
fascination  ->  شیفتگی
fatty  ->  چرب
feasible  ->  شدنی
feast  ->  جشن
feminine  ->  زنانه
fibre  ->  فیبر
filthy  ->  کثیف
flair  ->  استعداد
flaw  ->  نقص
flee  ->  فرار کن
fleet  ->  ناوگان
footstep  ->  قدم گذاشتن
foremost  ->  در درجه نخست
foresee  ->  پیش بینی
formally  ->  به طور رسمی
format  ->  قالب
formula  ->  فرمول
foul  ->  ناپاک
foundation  ->  پایه
friction  ->  اصطکاک
fright  ->  ترس
fruitful  ->  مثمر ثمر
frustrated  ->  ناامید شده
frustrating  ->  خسته کننده، اذیت کننده
fulfil  ->  برآورده کند
fumes  ->  دود
fund  ->  سرمایه
funding  ->  منابع مالی
furnished  ->  مبله شده
fuss  ->  سر و صدا
gadget  ->  ابزار
garment  ->  لباس
gathering  ->  جمع آوری
gene  ->  ژن
generalization  ->  تعمیم
generalize  ->  تعمیم دادن
genetic  ->  ژنتیکی
genetically modified  ->  اصلاح ژنتیکی شده
genius  ->  نابغه
geology  ->  زمين شناسي
germ  ->  ریشه
gerund  ->  جروند
gesture  ->  ژست
gifted  ->  با استعداد
glamour  ->  زرق و برق
glimpse  ->  نظر اجمالی
globalization (also uk globalisation)  ->  جهانی شدن (همچنین جهانی شدن انگلستان)
glory  ->  شکوه
grace  ->  رحمت
graceful  ->  برازنده
grand  ->  بزرگ
grasp  ->  فهم
greed  ->  طمع
gripping  ->  گرفتن
gross  ->  ناخالص
grounds  ->  زمینه
grumpy  ->  بد خلق
guideline  ->  راهنمای
habitat  ->  زیستگاه
harassment  ->  آزار و اذیت
hardship  ->  سختی
harsh  ->  خشن
hatred  ->  نفرت
hazard  ->  خطر
heading  ->  عنوان
health care  ->  مراقبت های بهداشتی
heavenly  ->  بهشتی
hectic  ->  گیج کننده
helpless  ->  درمانده
hence  ->  از این رو
heroic  ->  قهرمانانه
hesitation  ->  تردید
hilarious  ->  خنده دار
historian  ->  تاریخ شناس
historically  ->  تاریخی
holy  ->  مقدس
homeless  ->  بی خانمان
honoured  ->  مفتخر شد
hop  ->  هاپ
horizon  ->  افق
horizontal  ->  افقی
hospitable  ->  مهمان نواز
hospitality  ->  مهمان نوازی
hostile  ->  خصومت آمیز
housing  ->  مسکن
humanity  ->  بشریت
humorous  ->  طنز
hygiene  ->  بهداشت
hysterical  ->  هیستریک
iceberg  ->  کوه یخ
idealistic  ->  آرمان گرا
idol  ->  بت
illustration  ->  تصویر
imaginary  ->  خیالی
imaginative  ->  تخیلی
imitate  ->  تقلید کنید
immense  ->  عظیم
immensely  ->  به شدت
imperfect  ->  ناقص
impersonal  ->  غیر شخصی
implication  ->  پیامد
impose  ->  تحمیل کنند
imprison  ->  زندانی کردن
inability  ->  عجز
inaccuracy  ->  عدم دقت
inadequate  ->  ناکافی
inappropriate  ->  نامناسب
inappropriately  ->  نامناسب
incapable  ->  ناتوان
incidentally  ->  اتفاقا
inclined  ->  شیب دار
inclusion  ->  شمول
inclusive  ->  شامل
inconvenience  ->  ناراحتی
index  ->  فهرست مطالب
indication  ->  نشانه
indirect  ->  غیر مستقیم
indirectly  ->  غیر مستقیم
individually  ->  به طور جداگانه
industrialization  ->  صنعتی سازی
industrialized  ->  صنعتی شده
inedible  ->  غیر قابل خوردن
inefficient  ->  ناکارآمد
inevitable  ->  اجتناب ناپذیر
inevitably  ->  به ناچار
infect  ->  آلوده کردن
inferior  ->  پست تر
influential  ->  موثر
informally  ->  غیر رسمی
informative  ->  آموزنده
infrastructure  ->  زیر ساخت
initiative  ->  ابتکار عمل
injustice  ->  بی عدالتی
innocence  ->  بی گناهی
innovation  ->  نوآوری
innovative  ->  خلاقانه
insane  ->  مجنون
insecure  ->  ناامن
insensitive  ->  غیر حساس
insert  ->  درج کنید
insight  ->  بینش، بصیرت، درون بینی
insignificant  ->  ناچیز
inspect  ->  بازرسی
inspection  ->  بازرسی
installation  ->  نصب و راه اندازی
instruct  ->  دستور دادن
insufficient  ->  ناکافی
integral  ->  انتگرال
integrate  ->  ادغام کردن
integration  ->  ادغام
intense  ->  شدید، قوی
intensively  ->  به شدت
interaction  ->  اثر متقابل
interestingly  ->  جالب است
interference  ->  دخالت
internally  ->  داخلی
invaluable  ->  ارزشمند
irritate  ->  تحریک کردن
isolated  ->  جدا شده
isolation  ->  انزوا
itinerary  ->  برنامه سفر
jargon  ->  اصطلاحات تخصصی
jealousy  ->  حسادت
jointly  ->  به طور مشترک
journal  ->  مجله
junk  ->  جنس اوراق و شکسته
junk mail  ->  نامه های ناخواسته
justified  ->  تعدیل شده
juvenile  ->  نوجوان
knob  ->  دستگیره
knowledgeable  ->  آگاه
labour  ->  کار یدی
landmark  ->  نقطه عطف
lawn  ->  چمن
layout  ->  چیدمان
leadership  ->  رهبری
left-wing  ->  جناح چپ
legendary  ->  افسانهای
lengthen  ->  طولانی کردن
lengthy  ->  طولانی
lessen  ->  کاهش دادن
liability  ->  مسئولیت
liable  ->  مسئول
liberal  ->  لیبرال
liberation  ->  رهایی
limitation  ->  محدودیت
linguistic  ->  وابسته به زبانشناسی
listener  ->  شنونده
literacy  ->  سواد
logic  ->  منطق
loneliness  ->  تنهایی
long-time  ->  مدت زمان طولانی
lounge  ->  سالن استراحت
luxurious  ->  مجلل
machinery  ->  دستگاه
magistrate  ->  قاضی
magnetic  ->  مغناطیسی
magnificently  ->  به طرز باشکوهی
mammal  ->  پستاندار
masculine  ->  مردانه
mat  ->  تشک
mechanism  ->  سازوکار
memo  ->  یادداشت
mentality  ->  ذهنیت
merit  ->  شایستگی
migration  ->  مهاجرت
miner  ->  معدن کار
mingle  ->  مخلوط شدن
minimal  ->  حداقل
minimize  ->  به حداقل رساندن
mining  ->  معدن
ministry  ->  وزارت
misbehave  ->  بد رفتار کردن
misfortune  ->  بد شانسی
misinform  ->  اطلاعات غلط
mislead  ->  گمراه کردن
mistaken  ->  اشتباه کرد
mode  ->  حالت
moderation  ->  اعتدال
modestly  ->  متواضعانه
modification  ->  تغییر
modify  ->  تغییر
monotonous  ->  یکنواخت
motivate  ->  ایجاد انگیزه
multiple  ->  چندگانه
mundane  ->  دنیوی
municipal  ->  شهرداری
mustard  ->  خردل
mutual  ->  متقابل
mysteriously  ->  به طور مرموزی
naive  ->  آدم ساده
namely  ->  برای مثال
nap  ->  چرت زدن
narrow-minded  ->  تنگ نظر
neatly  ->  منظمی
necessity  ->  ضرورت
needless  ->  بی نیاز
neglect  ->  بی توجهی
negotiate  ->  مذاکره کنند
negotiation  ->  مذاکره
nerve  ->  عصب
nervousness  ->  عصبی بودن
networking  ->  شبکه
neutral  ->  خنثی
never-ending  ->  بی پایان
newsletter  ->  خبرنامه
nickname  ->  نام مستعار
noble  ->  نجیب
nominate  ->  نامزد کردن
nomination  ->  نامزدی
nonetheless  ->  با این وجود
non-existent  ->  موجود نیست
norm  ->  هنجار
notable  ->  قابل توجه
notably  ->  به ویژه
noticeable  ->  قابل توجه
noticeably  ->  قابل ملاحظه ای
notify  ->  مطلع ساختن
notion  ->  ایده
notorious  ->  بدنام
notwithstanding  ->  با وجود
numerous  ->  متعدد
nutrition  ->  تغذیه
nutritional  ->  غذایی
nutritious  ->  مغذی
nutshell  ->  مخلص کلام
obese  ->  چاق
obesity  ->  چاقی
objectively  ->  به طور عینی
obligatory  ->  واجب
obsolete  ->  منسوخ شده
obstacle  ->  مانع
occasional  ->  گاه به گاه
occurrence  ->  وقوع
odds  ->  شانس
officially  ->  رسما
omit  ->  حذف کردن
oneself  ->  خود
openly  ->  بی پرده
open-minded  ->  روشنفکر
opposed  ->  مخالف
opposition  ->  مخالفت
opt  ->  انتخاب کردن
optimist  ->  خوش بین
organ  ->  عضو
outcome  ->  نتیجه
outgoing  ->  برونگرا
outlook  ->  چشم انداز
outnumber  ->  از تعداد
outrage  ->  خشم
outweigh  ->  سنگین تر بودن از
overcrowded  ->  پر ازدحام
overdo  ->  زیاده روی
overdraft  ->  اضافه برداشت
overdrawn  ->  اضافه برداشت
overestimate  ->  بیش از حد
overview  ->  بررسی اجمالی
overwhelm  ->  غرق کردن
overwhelming  ->  غافلگیر کننده
overworked  ->  بیش از حد کار کرده
ownership  ->  مالکیت
ozone  ->  ازن
palm  ->  نخل
panel  ->  پانل
paradise  ->  بهشت
partially  ->  تا اندازه ای
participant  ->  شرکت کننده
pastry  ->  شیرینی
payable  ->  قابل پرداخت
peasant  ->  دهقان
peer  ->  همتا
pensioner  ->  مستمری بگیر
perceive  ->  درک
perfection  ->  کمال
perk  ->  امتیاز
personnel  ->  پرسنل
perspective  ->  چشم انداز
persuasive  ->  متقاعد کننده
phenomenon  ->  پدیده
pleasurable  ->  لذت بخش
plunge  ->  غوطه
pointless  ->  بیهوده
politically  ->  از نظر سیاسی
pony  ->  تسویه حساب
poorly  ->  ضعیف
populate  ->  پر جمعیت کردن
portable  ->  قابل حمل
pose  ->  ژست
possess  ->  در اختیار داشتن
postal  ->  پستی
posture  ->  وضعیت بدن
precaution  ->  احتیاط
predator  ->  شکارچی
pregnancy  ->  بارداری
prejudiced  ->  متعصب
preliminary  ->  مقدماتی
premises  ->  محل
presently  ->  در حال حاضر
preservation  ->  حفظ
prestige  ->  اعتبار
prestigious  ->  معتبر
presume  ->  فرض
primitive  ->  اولیه
principle  ->  اصل
prior  ->  قبل
privatize  ->  خصوصی کردن
privilege  ->  امتیاز
privileged  ->  ممتاز
probability  ->  احتمال
problematic  ->  مشکل ساز
proceed  ->  ادامه دهید
productivity  ->  بهره وری
programmer  ->  برنامه نویس
progression  ->  پیشرفت
projection  ->  طرح ریزی
prolong  ->  طولانی کردن
prolonged  ->  طولانی مدت
prominent  ->  برجسته
promising  ->  امیدوار کننده
proportion  ->  تناسب، قسمت
proposition  ->  قضیه
prospective  ->  آینده نگر
prosperity  ->  رفاه
prosperous  ->  موفق
prostitute  ->  فاحشه
protein  ->  پروتئین
provider  ->  ارائه دهنده
provision  ->  تدارک
publicly  ->  به صورت عمومی
pulse  ->  نبض
purely  ->  صرفا
purity  ->  خلوص
pursue  ->  دنبال کردن
pyramid  ->  هرم
quote  ->  نقل قول
racially  ->  نژادی
radiation  ->  تابش - تشعشع
radical  ->  افراطی
radically  ->  رادیکال
random  ->  تصادفی
randomly  ->  به صورت تصادفی
rank  ->  رتبه
rarity  ->  نادر بودن
rating  ->  رتبه بندی
ratio  ->  نسبت
rational  ->  گویا
readership  ->  خوانندگان
readiness  ->  آمادگی
readjust  ->  تنظیم مجدد
realistically  ->  واقع بینانه
realization  ->  تحقق
reassure  ->  اطمینان دادن
reassuring  ->  اطمینان بخش
rebellion  ->  شورش
rebellious  ->  سرکش
recharge  ->  شارژ مجدد
reconsider  ->  تجدید نظر کند
reconstruct  ->  بازسازی کنید
reconstruction  ->  بازسازی
recreate  ->  بازآفرینی
recruit  ->  استخدام کردن
recruitment  ->  استخدام
rectangle  ->  مستطیل
rectify  ->  اصلاح کردن
redevelop  ->  توسعه مجدد
redevelopment  ->  توسعه مجدد
redundancy  ->  افزونگی
refresh  ->  تازه کردن
refreshing  ->  طراوت بخش
refusal  ->  امتناع
regardless  ->  بدون در نظر گرفتن
regulate  ->  تنظیم کند
rehearse  ->  تمرین کنید
reign  ->  سلطنت کنند
reinforce  ->  تقویت کردن
relate  ->  مربوط بودن
relevance  ->  ارتباط
reliability  ->  قابلیت اطمینان
relocate  ->  نقل مکان
reluctant  ->  آنها تردید می کنند
reluctantly  ->  با اکراه
remarkably  ->  قابل توجه
reminder  ->  یادآور
render  ->  ارائه دادن
renewable  ->  تجدید پذیر
renewal  ->  بازسازی
renovate  ->  بازسازی کند
renovation  ->  نوسازی
reorganize  ->  سازماندهی مجدد
repeatedly  ->  به طور مکرر
repetitive  ->  تکراری
reproduce  ->  تکثیر
reproduction  ->  تولید مثل
reptile  ->  خزنده
republic  ->  جمهوری
reputable  ->  معتبر
resemble  ->  شبیه
resolve  ->  برطرف کردن
respectful  ->  احترام
respective  ->  قابل احترام
respectively  ->  به ترتیب
restart  ->  راه اندازی مجدد
restless  ->  بی قرار
restrain  ->  مهار کردن
restrict  ->  محدود کردن
restricted  ->  محصور
restriction  ->  محدودیت
retail  ->  خرده فروشی
rethink  ->  تجدید نظر کنید
revenue  ->  درآمد
rewarding  ->  پاداش
richness  ->  غنا
riot  ->  شورش
rip-off  ->  پاره کردن
rival  ->  رقیب
rocky  ->  سنگی
role model  ->  الگو
rudely  ->  بی ادبانه
rudeness  ->  بی ادبی
runway  ->  باند
sacred  ->  مقدس
sacrifice  ->  قربانی
saint  ->  قدیس
satisfactorily  ->  رضایت بخش
saving  ->  صرفه جویی در
scan  ->  اسکن کنید
scarce  ->  کمیاب
scare  ->  ترساندن
scenic  ->  خوش منظره
scholar  ->  محقق
scholarship  ->  بورس تحصیلی
scope  ->  محدوده
sector  ->  بخش
seemingly  ->  ظاهرا
selective  ->  انتخابی
self  ->  خود
self-catering  ->  خود پذیرایی
self-centred  ->  خود محوری
self-conscious  ->  خودآگاه
self-esteem  ->  اعتماد به نفس
selfishness  ->  خودخواهی
semi-detached  ->  نیمه جدا
sensational  ->  پر شور
sensibly  ->  معقولانه
sensitivity  ->  حساسیت
sequence  ->  توالی
serial  ->  سریال
setback  ->  عقب گرد
settlement  ->  توافق
sewing  ->  خیاطی
shabby  ->  کهنه
shameful  ->  شرم آور
sheer  ->  خالص، ناب
shield  ->  سپر
shortcoming  ->  کمبود
shorten  ->  کوتاه کردن
shuttle  ->  شاتل
shyness  ->  خجالتی بودن
side effect  ->  عوارض جانبی
significance  ->  اهمیت
similarly  ->  به طور مشابه
simplicity  ->  سادگی
simplify  ->  ساده کردن
simulation  ->  شبیه سازی
simultaneous  ->  همزمان
sincere  ->  مخلص - بی ریا - صمیمانه
sip  ->  جرعه جرعه
sketch  ->  طرح
slang  ->  زبان عامیانه
slavery  ->  برده داری
sleepless  ->  بی خوابی
slippery  ->  لغزنده
slogan  ->  شعار
slot  ->  اسلات
smog  ->  مه دود
smuggle  ->  قاچاق
soaring  ->  اوج گرفتن
socialist  ->  سوسیالیست
sole  ->  تنها
solely  ->  صرفا
solicitor  ->  وکیل دادگستری
solidarity  ->  همبستگی
solitude  ->  تنهایی
sow  ->  بکار
soya  ->  سویا
spacious  ->  بزرگ جادار فراخ
spam  ->  هرزنامه ها
speciality  ->  تخصص
specifically  ->  به طور مشخص
specification  ->  مشخصات
spectrum  ->  طیف
speculation  ->  حدس و گمان
speechless  ->  بی حرف
sphere  ->  کره
spin  ->  چرخش
spine  ->  ستون فقرات
splendid  ->  عالی
spokesman  ->  سخنگو
spokesperson  ->  سخنگو
sponsorship  ->  حمایت
sporty  ->  ورزشی
stability  ->  ثبات
stable  ->  پایدار
staggering  ->  سرسام آور
staircase  ->  راه پله
stale  ->  کهنه
stamina  ->  استقامت
starve  ->  گرسنگی
state-of-the-art  ->  دولت از هنر
statistic  ->  آمار
statistical  ->  آماری
status  ->  وضعیت
status symbol  ->  نماد وضعیت
stem  ->  ساقه
stereotype  ->  کلیشه
stocking  ->  جوراب ساق بلند
stock market  ->  بازار سهام
strategic  ->  راهبردی
straw  ->  پوشال
striker  ->  مهاجم
strip  ->  نوار
stroll  ->  قدم زدن
subjective  ->  ذهنی
subsequent  ->  متعاقب
subsequently  ->  متعاقبا
subsidy  ->  یارانه
substantially  ->  بطور قابل ملاحظه ای
substitution  ->  جایگزینی
subtitles  ->  زیرنویس
successor  ->  جانشین
sue  ->  شکایت کند
sufficiently  ->  به اندازه کافی
suitability  ->  مناسب بودن
summarize  ->  خلاصه کردن
summit  ->  اجلاس - همایش
superior  ->  برتر
supervision  ->  نظارت
supervisor  ->  سرپرست
supportive  ->  حمایت کننده
supposedly  ->  ظاهرا
surge  ->  موج
surgeon  ->  جراح
sustainable  ->  پایدار
swap  ->  مبادله
tactic  ->  تاکتیک
takeover  ->  به عهده گرفتن
talkative  ->  پرحرف
tank  ->  مخزن
tasteless  ->  بی مزه
teamwork  ->  کار گروهی
technically  ->  از نظر فنی
technician  ->  تکنسین
techno  ->  تکنو
technologically  ->  از نظر فن آوری
tedious  ->  خسته کننده
telly  ->  تلویزیونی
tendency  ->  گرایش
tertiary  ->  درجه سوم
texture  ->  بافت
thankful  ->  سپاسگزار
thankfully  ->  خوشبختانه
the middle class  ->  طبقه متوسط
therapeutic  ->  درمانی
therapist  ->  درمانگر
thereby  ->  در نتیجه
the upper class  ->  طبقه بالا
the working class  ->  طبقه کارگر
thrill  ->  هیجان
thrive  ->  رشد کردن
time-consuming  ->  زمان بر
tobacco  ->  تنباکو
token  ->  نشانه
tolerant  ->  متحمل
toll  ->  عوارض
torture  ->  شکنجه
toss  ->  پرتاب کردن
trainee  ->  کارآموز
tranquil  ->  آرام
transaction  ->  معامله
transformation  ->  دگرگونی
transmit  ->  انتقال. رساندن
transportation  ->  حمل و نقل
trek  ->  پیاده روی طولانی
trigger  ->  ماشه
triumph  ->  پیروزی
troubled  ->  مشکل دار
trustworthy  ->  قابل اعتماد
tuition  ->  شهریه
turnover  ->  حجم معاملات
twist  ->  پیچ - پیچیدن
ultimately  ->  در نهایت
unaffordable  ->  مقرون به صرفه نیست
unavoidable  ->  اجتناب ناپذیر
uncertainty  ->  عدم قطعیت
uncomfortably  ->  ناراحت کننده
uncommon  ->  غیر معمول
unconventional  ->  غیر متعارف
uncover  ->  برملا کردن
undeniable  ->  غیر قابل انکار
undergo  ->  تحت
underpaid  ->  کمتر پرداخت شده است
understandably  ->  قابل درک
undertake  ->  بعهده گرفتن
unfold  ->  گشودن
unforeseen  ->  پیش بینی نشده
unite  ->  متحد کردن
unity  ->  وحدت
universally  ->  جهانی
unjustified  ->  غیر موجه
unload  ->  تخلیه
unmarried  ->  مجرد
unnecessarily  ->  غیر ضروری
unnoticed  ->  بدون توجه
unpaid  ->  پرداخت نشده
unproductive  ->  غیر مولد
unprofessional  ->  غیر حرفه ای
unqualified  ->  فاقد صلاحیت
unquestionably  ->  بدون شک
unreal  ->  غیر واقعی
unreasonably  ->  غیر منطقی
unrelated  ->  غیر مرتبط
unsafe  ->  ناامن
unsolved  ->  حل نشده
unspoiled  ->  دست نخورده
unsuccessfully  ->  ناموفق
unthinkable  ->  غیر قابل تصور
untouched  ->  دست نخورده
untrue  ->  نادرست
unwanted  ->  ناخواسته
unwillingly  ->  ناخواسته
unwillingness  ->  عدم تمایل
unwind  ->  باز کردن از پیچ
upcoming  ->  آینده
upper-class  ->  طبقه بالا
upward  ->  بطرف بالا
upwards  ->  به سمت بالا
urge  ->  اصرار
usage  ->  استفاده
usefulness  ->  مفید بودن
utmost  ->  بیشترین
utterly  ->  کاملا
vacancy  ->  جای خالی
vague  ->  مبهم
vain  ->  بیهوده
variable  ->  متغیر
vegetation  ->  زندگی گیاهی
veil  ->  حجاب
vein  ->  رگ
verify  ->  تایید کنید
versus  ->  در مقابل
vertical  ->  عمودی
vest  ->  جلیقه
vice versa  ->  برعکس
viewpoint  ->  نظر
vine  ->  تاک
voluntary  ->  داوطلبانه
walker  ->  واکر
warrior  ->  جنگجو
weaken  ->  تضعیف شود
well-being  ->  تندرستی
well-educated  ->  خوب تحصیل کرده
well-equipped  ->  مجهز
well-informed  ->  به خوبی آگاه است
well-off  ->  ثروتمند
well-qualified  ->  واجد شرایط
whatsoever  ->  به هر حال
widespread  ->  بطور گسترده
wisely  ->  عاقلانه
wit  ->  بذله گویی
witch  ->  جادوگر
withdraw  ->  کنار کشیدن
workforce  ->  نیروی کار
workplace  ->  محل کار
workshop  ->  کارگاه
worsen  ->  بدتر شدن
worship  ->  عبادت
worthless  ->  بی ارزش
worthy  ->  شایسته
youngster  ->  جوان

C2
--
abrupt  ->  ناگهانی
abruptly  ->  ناگهان
abusive  ->  بد لحن
accord  ->  توافق
accountable  ->  پاسخگو
accumulation  ->  انباشت
acre  ->  هکتار
adjacent  ->  مجاور
adolescent  ->  نوجوان
adverse  ->  نامطلوب
affectionate  ->  محبت آمیز
albeit  ->  کار کردن
allege  ->  ادعا کردن
allegedly  ->  ظاهرا
alliance  ->  اتحاد
allied  ->  متحد
allocation  ->  تخصیص
ambiguity  ->  گنگ
ambiguous  ->  مبهم
amend  ->  اصلاح
analogous  ->  مشابه
analogy  ->  مقایسه
anchor  ->  لنگر
anonymous  ->  ناشناس
antibiotic  ->  آنتی بیوتیک
anticipation  ->  پیش بینی
apologetic  ->  عذرخواهی
arbitrary  ->  دلخواه
arch  ->  قوس
arid  ->  خشک
arouse  ->  برانگیختن
artificial intelligence  ->  هوش مصنوعی
aspiration  ->  تنفس
aspire  ->  آرزو می کنم
aspiring  ->  مشتاق
assault  ->  حمله
assemble  ->  جمع آوری کنید
assembly  ->  مونتاژ
assertive  ->  اظهار کننده
astronomy  ->  ستاره شناسی
attainable  ->  قابل دستیابی
awe  ->  هیبت
backing  ->  پشتیبان
backward  ->  رو به عقب
bandwagon  ->  واگن
barn  ->  انبار غله
being  ->  بودن
bias  ->  جانبداری
bind  ->  بستن
blackmail  ->  باج گیری
bland  ->  ملايم
bleak  ->  تاریک
blend  ->  مخلوط کردن
blister  ->  تاول زدن
blunt  ->  صریح
breadth  ->  وسعت
bribery  ->  رشوه دادن
brink  ->  لبه لبه
broadminded  ->  گشاده فکر
bundle  ->  دسته
bureaucracy  ->  بوروکراسی
burial  ->  خاکسپاری
butt  ->  لب به لب
buzz  ->  وزوز
capitalism  ->  نظام سرمایه داری
capitalist  ->  سرمایه دار
carefree  ->  بی خیال
cargo  ->  محموله
carve  ->  تراشیدن
casserole  ->  قابلمه
casualty  ->  سانحه، کشته
catastrophe  ->  فاجعه
chancellor  ->  صدراعظم
chapel  ->  نمازخانه
charisma  ->  جذابیت
charismatic  ->  کاریزماتیک
cheerfulness  ->  نشاط
chronic  ->  مزمن
circuit  ->  جریان
circulation  ->  جریان
civilian  ->  غیر نظامی
clarity  ->  وضوح
clash  ->  برخورد
classification  ->  طبقه بندی
cliché  ->  کلیشه ای
clichéd  ->  کلیشه ای
cling  ->  چسبیدن
closure  ->  بسته
clumsiness  ->  دست و پا چلفتی
coastline  ->  خط ساحلی
coherence  ->  انسجام
coherent  ->  منسجم
coincide  ->  مصادف شدن
coldness  ->  سردی
combat  ->  مبارزه کن
comeback  ->  بازگشت
comforting  ->  آرامش بخش
commander  ->  فرمانده
commemorate  ->  بزرگداشت
commence  ->  آغاز شود
committed  ->  متعهد شد
complexion  ->  رنگ چهره
complexity  ->  پیچیدگی
complimentary  ->  تعارفی
compulsive  ->  اجباری
conceal  ->  پنهان کردن، پوشاندن
concede  ->  قبول کردن
conceited  ->  متکبر
conceive  ->  حامله شدن
conception  ->  دریافت، آبستنی
concession  ->  امتیاز
conclusive  ->  قطعی
conclusively  ->  به طور قطعی
condemn  ->  محکوم کردن
confine  ->  محدود کردن
confront  ->  مواجه شدن
confrontation  ->  تقابل
conscience  ->  وجدان
consecutive  ->  متوالی
consensus  ->  اجماع، وفاق
consistent  ->  استوار
consistently  ->  همواره
constitutional  ->  مشروطه
constrain  ->  محدود کردن
constraint  ->  محدودیت
consultation  ->  مشاوره
contemplate  ->  اندیشیدن
contempt  ->  تحقیر
continental  ->  قاره
continuity  ->  تداوم
contraception  ->  پیشگیری از بارداری
contraceptive  ->  ضد بارداری
contradiction  ->  تناقض
contradictory  ->  متناقض
conversion  ->  تبدیل
convict  ->  محکوم
conviction  ->  محکومیت
cookie  ->  کوکی
coral  ->  مرجان
core  ->  هسته
corpse  ->  جسد
corresponding  ->  متناظر
counselling  ->  مشاوره
counsellor  ->  مشاور
coup  ->  کودتا
courteous  ->  مودب
crackdown  ->  سرکوب
crave  ->  هوس کردن
craving  ->  میل شدید به
craziness  ->  دیوانگی
credibility  ->  اعتبار
creep  ->  خزیدن
crude  ->  خام
crumble  ->  فرو ریختن
crush  ->  خرد کردن
cunning  ->  حیله گری
curb  ->  محدود کردن
custody  ->  حضانت
cutlery  ->  کارد و چنگال
cynical  ->  بدبینانه
dated  ->  تاریخ دار
dazed  ->  مات و مبهوت
dazzle  ->  خیره شدن
dazzling  ->  خیره کننده
decaffeinated  ->  بدون کافئین
deceased  ->  مرحوم
deception  ->  فریب
deceptive  ->  فریبنده
decisively  ->  قاطعانه
deduce  ->  استنباط
deem  ->  به نظر
defective  ->  معیوب
defensive  ->  دفاعی
definitive  ->  قطعی
defy  ->  سرپیچی کردن
delegation  ->  هیئت نمایندگی
denial  ->  انکار
dependence  ->  وابستگی
depict  ->  تصور کن
deprivation  ->  محرومیت
descendant  ->  نسل
desired  ->  دلخواه
desperation  ->  ناامیدی
deterrent  ->  بازداشتن
detrimental  ->  مضر
devastation  ->  ویرانی
devise  ->  تدبیر
diagnose  ->  تشخیص دادن
diagnosis  ->  تشخیص
dialect  ->  گویش
diarrhoea  ->  اسهال
dice  ->  تاس
dignified  ->  بلند مرتبه
dignity  ->  کرامت
dim  ->  کم نور
diplomacy  ->  دیپلماسی
diplomatically  ->  دیپلماتیک
disclose  ->  فاش کردن
discreet  ->  با احتیاط
discretion  ->  اختیار
disgust  ->  انزجار
disillusioned  ->  سرخورده
disloyal  ->  بی وفا
dismay  ->  ناراحتی
disposable  ->  قابل عرضه
disposable income  ->  درآمد قابل تصرف
disposed  ->  بیرون انداخته شده
disposition  ->  وضع
disqualify  ->  رد صلاحیت
disrespectful  ->  بی احترامی
disruptive  ->  مخرب
disturbed  ->  مختل
disturbing  ->  مزاحم
dna  ->  DNA
dole  ->  دول
dominance  ->  تسلط
donor  ->  اهدا کننده
doom  ->  عذاب
doorway  ->  درگاه
downhill  ->  سراشیبی
drain  ->  زه کشی
dread  ->  وحشت
drift  ->  رانش
drought  ->  خشکسالی
dubious  ->  مشکوک
eccentric  ->  عجیب و غریب
echo  ->  اکو
elaborate  ->  دارای جزئیات - بسیط
elapse  ->  گذشت
elated  ->  سرخوش
elimination  ->  حذف
elusive  ->  گریزان
embarrass  ->  شرم آور
embody  ->  مجسم کردن
eminent  ->  برجسته
emit  ->  بیرون ریختن
empathy  ->  یکدلی
empirical  ->  تجربی
endorse  ->  تایید و امضا
endow  ->  وقف کردن
endurance  ->  تحمل
engrossed  ->  غرق شده
entity  ->  وجود، موجودیت
equate  ->  برابر کردن
eradicate  ->  ریشه کن کردن
erode  ->  فرسایش
erupt  ->  فوران
essence  ->  ذات
ethic  ->  اخلاق
ethical  ->  اخلاقی
eventful  ->  پر حادثه
eventual  ->  نهایی
excel  ->  برتری داشتن
exclaim  ->  بانگ زدن
execute  ->  اجرا کردن
exemplify  ->  مثال زدن
exile  ->  تبعید
expenditure  ->  مخارج
experimental  ->  تجربی
expire  ->  منقضی شود
explicit  ->  صریح
explosive  ->  مواد منفجره
expressive  ->  رسا
exquisite  ->  نفیس
extravagant  ->  مسرف
extremist  ->  افراطی
facial  ->  صورت
familiarize  ->  آشنا کردن
famine  ->  قحطی
fanatic  ->  متعصب
faraway  ->  خیلی دور
faultless  ->  بی عیب
fearful  ->  ترسناک
fearless  ->  بی باک
feat  ->  شاهکار
feeble  ->  ضعیف
fend  ->  دفع کردن
fertile  ->  بارور
fictional  ->  تخیلی
filter  ->  فیلتر
fingertip  ->  نوک انگشت
finite  ->  محدود، فانی
fireplace  ->  بخاری
fist  ->  مشت
flashback  ->  فلاش بک
flatten  ->  صاف کردن
flawed  ->  ناقص
flawless  ->  بی عیب و نقص
flesh  ->  گوشت
flick  ->  تلنگر
floppy  ->  فلاپی
flourish  ->  شکوفا شدن
fluctuate  ->  نوسان می کند
fluid  ->  مایع
follower  ->  دنباله رو
forceful  ->  نیرومند
foreseeable  ->  قابل پیش بینی
forgery  ->  جعل
forgiveness  ->  بخشش
formation  ->  تشکیل
formidable  ->  مهیب
formulate  ->  فرموله کردن
founder  ->  موسس
fraction  ->  کسر
fragile  ->  شکننده
fragrance  ->  عطر
fragrant  ->  معطر
frail  ->  نحیف
framework  ->  چارچوب
frantic  ->  از کوره در رفته
fraud  ->  تقلب
fraudulent  ->  جعلی
frenzy  ->  دیوانگی
fringe  ->  حاشیه
frontier  ->  مرز
frown  ->  اخم
fulfilling  ->  انجام
fulfilment  ->  تحقق
fundamental  ->  اساسی
fundamentally  ->  اساسا
fury  ->  خشم
fussy  ->  ایراد گیر
gamble  ->  قمار
gasp  ->  نفس کشیدن
giggle  ->  خندیدن
glare  ->  تابش خیره کننده
globe  ->  کره زمین
glow  ->  درخشش
glue  ->  چسب
goodness  ->  خوبی
grain  ->  غلات
grammatical  ->  دستوری
grim  ->  تلخ
grin  ->  پوزخند
groan  ->  ناله
gulf  ->  خلیج
hail  ->  تگرگ
handy  ->  دستی
harshly  ->  به شدت
haul  ->  حمل و نقل
hazardous  ->  خطرناک
heap  ->  پشته
heir  ->  وارث
heritage  ->  میراث
hierarchical  ->  بر اساس سلسله مراتب
hierarchy  ->  سلسله مراتب
high-profile  ->  با مشخصات بالا
hinder  ->  مانع شود
hollow  ->  توخالی
homelessness  ->  بی خانمانی
hopelessly  ->  ناامیدانه
horrified  ->  وحشت زده
horrifying  ->  وحشتناک
hostage  ->  گروگان
hostility  ->  خصومت
hum  ->  زمزمه
humanitarian  ->  بشردوستانه
humble  ->  فروتن
humiliated  ->  تحقیر شده
humiliating  ->  تحقیر کننده
humility  ->  فروتنی
hygienic  ->  بهداشتی
hypocrisy  ->  دورویی
hypocritical  ->  ریاکارانه
hypothesis  ->  فرضیه
icily  ->  یخی
idle  ->  بیکار
ignorance  ->  جهل
ignorant  ->  نادان
illiterate  ->  بی سواد
illusion  ->  توهم
imitation  ->  تقلید
immature  ->  نابالغ
imminent  ->  قریب الوقوع
immortal  ->  جاویدان
immune  ->  مصون
immune system  ->  سیستم ایمنی
impatience  ->  بی حوصلگی
implementation  ->  پیاده سازی
implicit  ->  ضمنی
imply  ->  دلالت
impossibility  ->  عدم امکان
imprisonment  ->  زندان
impulse  ->  تکانه
impulsive  ->  تکانشی
incentive  ->  مشوق
inclination  ->  تمایل
inconceivable  ->  غیر قابل تصور
inconsiderate  ->  بی ملاحظه
incorporate  ->  گنجاندن
incur  ->  متحمل شدن
incurable  ->  غیر قابل درمان
indefinitely  ->  به طور نامحدود
indicator  ->  نشانگر
indifference  ->  بی تفاوتی
indifferent  ->  بي تفاوت
indispensable  ->  ضروری
indisputable  ->  بی چون و چرا
individuality  ->  فردیت
indulge  ->  افراط کردن
industrious  ->  سخت کوش
inequality  ->  نابرابری
inexplicable  ->  غیر قابل توضیح
infancy  ->  دوران نوزادی
infant  ->  نوزاد
infectious  ->  عفونی
infer  ->  نتیجه گیری
inferiority  ->  حقارت
infinite  ->  نا محدود
infinitely  ->  بی نهایت
influx  ->  هجوم
inhabit  ->  ساکن است
inherent  ->  ذاتی
inherit  ->  شما ارث می برید
inheritance  ->  وراثت
inhibition  ->  بازداری
inhuman  ->  غیر انسانی
initiate  ->  آغازکردن
injection  ->  تزریق
innate  ->  ذاتی
innumerable  ->  بی شمار
insecurity  ->  ناامنی
inseparable  ->  جدایی ناپذیر
insofar as  ->  تا جایی که
insomnia  ->  بیخوابی
instinct  ->  غریزه
intact  ->  سالم
integrity  ->  تمامیت
intellect  ->  عقل
intellectually  ->  از نظر فکری
intensely  ->  به شدت
intensify  ->  تشدید شود
intensity  ->  شدت
intent  ->  قصد
interim  ->  موقت
interpretation  ->  تفسیر
intervene  ->  دخالت
intervention  ->  مداخله
intimate  ->  صمیمی
intolerable  ->  غير قابل تحمل
intolerance  ->  عدم تحمل
intolerant  ->  بی تحمل
intriguing  ->  جذاب
intrinsic  ->  ذاتی
introvert  ->  درونگرا
intrude  ->  سرزده
intruder  ->  مزاحم
intrusion  ->  نفوذ
intuition  ->  بینش
invariably  ->  همیشه
ironic  ->  کنایه آمیز
ironically  ->  از قضا
irony  ->  کنایه
irrational  ->  غیر منطقی
irresistible  ->  مقاومت ناپذیر
irrespective  ->  قطع نظر از
irreversible  ->  غیر قابل برگشت
irritable  ->  تحریک پذیر
irritation  ->  تحریک
juggle  ->  شعبده بازی
justifiable  ->  قابل توجیه
justification  ->  توجیه
kidney  ->  کلیه
knot  ->  گره
knowingly  ->  آگاهانه
knuckle  ->  بند انگشت
lad  ->  پسر
laid-back  ->  آرام
lavish  ->  مجلل
leap  ->  جهش
legacy  ->  میراث
legislation  ->  قانون گذاری
legitimate  ->  مشروع
lenient  ->  ملایم
lethal  ->  مرگبار
lifelong  ->  مادام العمر
lifespan  ->  طول عمر
likelihood  ->  احتمال
likewise  ->  به همین ترتیب
linen  ->  کتانی
linger  ->  درنگ
literal  ->  تحت اللفظی
literate  ->  با سواد
loathe  ->  متنفر بودن
loathing  ->  نفرت
loft  ->  زیر شیروانی
logically  ->  منطقی
longevity  ->  طول عمر
longing  ->  اشتیاق
long-lasting  ->  طولانی مدت
long-running  ->  طولانی مدت
loom  ->  بافندگی
loosen  ->  شل کردن
lucrative  ->  سودآور
lump  ->  توده
lure  ->  طعمه
mainstream  ->  مسیر اصلی
malicious  ->  مخرب
margin  ->  لبه
marginal  ->  حاشیه ای
massacre  ->  قتل عام
masterpiece  ->  شاهکار
materialism  ->  ماتریالیسم
materialist  ->  ماتریالیست
materialistic  ->  مادی گرا
maximize  ->  به حداکثر رساندن
medically  ->  از نظر پزشکی
medication  ->  دارو
mediocre  ->  متوسط
mediocrity  ->  متوسط ​​بودن
melody  ->  ملودی
memorial  ->  یادبود
merciful  ->  رحیم - مهربان
merciless  ->  بی رحم
mercy  ->  رحمت
merge  ->  ادغام
merger  ->  ادغام
metaphor  ->  استعاره
meticulous  ->  دقیق
mighty  ->  توانا
millennium  ->  هزاره
miniature  ->  مینیاتوری
mishap  ->  بدبختی
misinterpret  ->  سوء تعبیر کند
misinterpretation  ->  تفسیر نادرست
misplace  ->  نابجا
missile  ->  موشک
moan  ->  ناله
moderately  ->  نسبتا
momentum  ->  تکانه
monetary  ->  پولی
monopoly  ->  انحصار
morale  ->  روحیه
mortality  ->  مرگ و میر
motion  ->  حرکت - جنبش
mount  ->  کوه
muddle  ->  درهم ریختن
muddled  ->  به هم ریخته
murmur  ->  زمزمه کردن
musically  ->  از نظر موسیقی
narrative  ->  روایت
narrator  ->  راوی
naval  ->  نیروی دریایی
negligence  ->  غفلت
negligent  ->  سهل انگاری
negligible  ->  قابل اغماض
nest  ->  لانه
normality  ->  عادی بودن
nostalgia  ->  نوستالژی
nostalgic  ->  نوستالژیک
nostril  ->  سوراخ بینی
nosy  ->  فضول
novelty  ->  تازگی
obscene  ->  ناپسند
observant  ->  ناظر
observer  ->  مشاهده کننده
obsessive  ->  وسواسی
oddly  ->  به طرز عجیبی
odour  ->  بو
off-putting  ->  بیهوده
offset  ->  انحراف
offspring  ->  فرزندان
omission  ->  حذف
ongoing  ->  در دست اقدام
onwards  ->  به بعد
openness  ->  باز بودن
optimism  ->  خوش بینی
ordeal  ->  مصیبت
orientation  ->  گرایش
originate  ->  سرچشمه
ornament  ->  زینت
orphan  ->  یتیم
orthodox  ->  ارتدکس
outbreak  ->  شیوع
outgoings  ->  خروجی ها
outlet  ->  پریز
output  ->  خروجی
outset  ->  ابتدا
overboard  ->  روی دریا
overflow  ->  سرریز
overhear  ->  شنیدن
overlap  ->  همپوشانی
pact  ->  پیمان
paradigm  ->  الگو
paradox  ->  پارادوکس
paradoxical  ->  متناقض
parallel  ->  موازی
paramount  ->  برترین
particle  ->  ذره
pastime  ->  سرگرمی
pat  ->  ضربه زدن
patch  ->  پچ
pathetic  ->  تأسفبار - رقت انگیز
peep  ->  چشمک زدن
peer pressure  ->  فشار همسالان
perception  ->  ادراک
perceptive  ->  درخشان
perseverance  ->  استقامت
persist  ->  اصرار ورزیدن
persistence  ->  ماندگاری
persistent  ->  مداوم
persuasion  ->  متقاعد کردن
petty  ->  خرده پا
phenomenal  ->  فوق العاده
philosophical  ->  فلسفی
pinpoint  ->  مشخص کردن
pioneer  ->  پیشگام
pit  ->  گودال
pitiful  ->  رقت انگیز
plague  ->  طاعون
plausible  ->  محتمل
plea  ->  درخواست
plead  ->  لابه کردن
plethora  ->  مقدار زیاد
plight  ->  مصیبت
plump  ->  چاق
poetic  ->  شاعرانه
pole  ->  قطب
ponder  ->  اندیشیدن
portray  ->  تصویر کشیدن
portrayal  ->  به تصویر کشیدن
practitioner  ->  متخصص
pragmatic  ->  عملگرا
precede  ->  مقدم بودن
precedent  ->  سابقه
predecessor  ->  سلف، اسبق، جد
predominant  ->  غالب
predominantly  ->  عمدتا
premium  ->  حق بیمه
prescribe  ->  تجویز کند
presumption  ->  فرض
prevail  ->  غالب شدن پیروز شدن چیره شدن
preventive  ->  پیشگیرانه
prey  ->  طعمه
prime  ->  نخست
proceedings  ->  اقدامات
procession  ->  راهپیمایی
profound  ->  عمیق
profoundly  ->  عمیقا
prone  ->  دمر
propaganda  ->  تبلیغات
prosecute  ->  تحت تعقیب قرار دادن
prosecution  ->  پیگرد قانونی
prosecutor  ->  دادستان
prosper  ->  رونق
protagonist  ->  قهرمان داستان
proverb  ->  ضرب المثل
province  ->  استان
provincial  ->  استانی
provocation  ->  تحریک
provoke  ->  تحریک
proximity  ->  نزدیکی
psychiatrist  ->  روانپزشک
pursuit  ->  دستیابی
pushy  ->  زورگو
quaint  ->  عجیب و غریب
quest  ->  جستجو
questionable  ->  سوال برانگیز
quotation  ->  نقل قول
racist  ->  نژاد پرست
raid  ->  حمله
rally  ->  تجمع
rash  ->  کهیر
realm  ->  قلمرو
reap  ->  درو
reasoning  ->  استدلال
reassurance  ->  اطمینان خاطر
receptive  ->  پذیرا
reckless  ->  بی پروا
recognition  ->  به رسمیت شناختن
recollect  ->  به یاد بیاور
recollection  ->  یادآوری
reconcile  ->  وفق دادن
recreational  ->  تفریحی
recur  ->  عود کند
redistribute  ->  توزیع مجدد
referendum  ->  همه پرسی
refine  ->  پالودن
refined  ->  تصفیه شده
reform  ->  اصلاح
refrain  ->  خودداری
refuge  ->  پناه
regime  ->  رژیم
rejection  ->  طرد شدن
relentless  ->  بی امان
relentlessly  ->  بی امان
reliance  ->  تکیه
reliant  ->  متکی
relieve  ->  از بین بردن
relish  ->  لذت بردن
remorse  ->  پشیمانی
renowned  ->  مشهور
repeated  ->  تکرار کرد
repetition  ->  تکرار
reportedly  ->  گزارش شده است
representation  ->  نمایندگی
reproach  ->  سرزنش
resemblance  ->  شباهت
resent  ->  کینه توز
resentment  ->  رنجش
reserved  ->  رزرو شده است
resignation  ->  استعفا
resilience  ->  انعطاف پذیری
resilient  ->  ارتجاعی
resistance  ->  مقاومت
resolution  ->  وضوح
resourceful  ->  مدبر
respectfully  ->  با احترام
restraint  ->  خویشتن داری - خودداری - پرهیز
restrictive  ->  محدود کننده
restructure  ->  تجدید ساختار
retailer  ->  خرده فروش
retain  ->  حفظ
retention  ->  حفظ
retrace  ->  ردیابی مجدد
retreat  ->  عقب نشینی
retrieve  ->  بازیابی
retrospect  ->  نگاه به گذشته
reunion  ->  تجدید دیدار
revelation  ->  افشا
reversal  ->  واژگونی
reversible  ->  برگشت پذیر
revert  ->  برگرداندن
revival  ->  احیای
revive  ->  احیای
revolt  ->  شورش
rhyme  ->  قافیه
ribbon  ->  روبان
riches  ->  ثروت
right-wing  ->  بال سمت راست
rigid  ->  سفت و سخت
ritual  ->  مراسم
rivalry  ->  رقابت
roar  ->  غرش
rosy  ->  گلگون
rot  ->  پوسیدگی
ruling  ->  حکم می کند
rut  ->  شیار
ruthless  ->  بی رحم
sadden  ->  غمگین
saddle  ->  زین اسب
sanction  ->  تحریم
sane  ->  عاقل
sarcastic  ->  طعنه آمیز
saying  ->  گفتن
scarcely  ->  به ندرت
scarcity  ->  کمبود
scattered  ->  پراکنده شده است
scenario  ->  سناریو
sceptical  ->  مشکوک
schooling  ->  تحصیل در مدرسه
scramble  ->  تقلا
scrap  ->  باطله
scroll  ->  طومار
scruffy  ->  ژولیده
scrutiny  ->  بررسی موشکافانه
secluded  ->  منزوی
sedentary  ->  نشسته
seduce  ->  از راه بدر کردن
self-assurance  ->  اعتماد به نفس
self-assured  ->  مطمئن به خود
self-awareness  ->  خودآگاهی
self-control  ->  خود کنترلی
self-discipline  ->  خود انضباطی
self-made  ->  خود ساخته
self-reliance  ->  خود اتکایی
self-reliant  ->  متکی به خود
self-respect  ->  احترام به خود
self-sufficient  ->  خودبسنده
senseless  ->  بدون احساس
sensibility  ->  حساسیت
sentiment  ->  احساسات
sentimental  ->  احساساتی
serene  ->  آرام
serenity  ->  آرامش
severity  ->  شدت
shaken  ->  تکان داده شده است
sharpen  ->  تیز کردن
shattered  ->  متلاشی شد
short-sighted  ->  کوته فکر
shrewd  ->  زیرک
shrug  ->  شانه بالا انداختن
shudder  ->  لرزیدن
sibling  ->  خواهر و برادر
sideways  ->  به پهلو
simplification  ->  ساده سازی
sin  ->  گناه
sincerity  ->  خلوص
siren  ->  آژیر
skull  ->  جمجمه
slaughter  ->  ذبح
slender  ->  باریک
smoky  ->  دودی
snap  ->  ضربه محکم و ناگهانی
snatch  ->  قاپیدن
sneak  ->  یواشکی
sniff  ->  بو کشیدن
snob  ->  اسنوب
snobbish  ->  اسنوب
soar  ->  اوج گرفتن
sober  ->  هوشیار
socialism  ->  سوسیالیسم
solitary  ->  منفرد، مجد، تنها، منزوی، انفرادی
soothing  ->  آرامش بخش
sorrow  ->  غم و اندوه
spade  ->  بیل
spark  ->  جرقه
sparsely  ->  به صورت پراکنده
specimen  ->  نمونه
speculate  ->  حدس و گمان
spending  ->  خرج کردن
spiral  ->  مارپیچ
spiritually  ->  از نظر معنوی
spit  ->  تف انداختن
splendour  ->  شکوه
spotless  ->  بی عیب
spotlight  ->  نور افکن
spouse  ->  همسر
sprinkle  ->  پاشیدن
spur  ->  تحریک
squad  ->  تیم
squander  ->  اسراف کردن
squeak  ->  جیر جیر
squeaky  ->  جیرجیر
stagger  ->  تلو تلو خوردن
stake  ->  سهام
stance  ->  حالت
standpoint  ->  دیدگاه
stardom  ->  ستاره شدن
starvation  ->  گرسنگی
stereotypical  ->  کلیشه ای
stern  ->  سختگیر
stimulus  ->  محرک
stitch  ->  کوک
strand  ->  رشته
stranded  ->  سرگردان
strap  ->  بند
strategically  ->  استراتژیک
strenuous  ->  سخت
strive  ->  تلاش کردن
structural  ->  ساختاری
structured  ->  ساختار یافته
stubbornness  ->  سرسختی
stumble  ->  تلو تلو خوردن
stunned  ->  شوکه شده
stupidity  ->  حماقت
subconsciously  ->  ناخودآگاه
subtle  ->  نامحسوس
successive  ->  پی در پی
succumb  ->  تسلیم شدن
suck  ->  مکیدن
sufferer  ->  مبتلا
summon  ->  احضار
superficial  ->  سطحی
superficially  ->  سرتاسر
superfluous  ->  زیادی
superiority  ->  برتری
supplementary  ->  مکمل
suppress  ->  سرکوب کردن
surpass  ->  پیشی گرفتن
surplus  ->  مازاد
surrender  ->  تسلیم شدن
suspense  ->  تعلیق
sustain  ->  حفظ کنند
sustainability  ->  پایداری
swift  ->  سریع
swiftly  ->  به سرعت
syllabus  ->  سرفصل دروس
symbolic  ->  نمادین
sympathize  ->  همدردی کردن
synonym  ->  مترادف
synonymous  ->  مترادف
systematic  ->  نظام
systematically  ->  به صورت سیستماتیک
tact  ->  تدبیر
tactful  ->  با درایت
tactless  ->  بی تدبیر
talks  ->  صحبت می کند
tangible  ->  محسوس
tasteful  ->  خوش سلیقه
taxpayer  ->  مالیات دهنده
tenant  ->  مستاجر
tender  ->  مناقصه
tenderness  ->  لطافت
territorial  ->  سرزمینی
testify  ->  گواهی دادن
theoretical  ->  نظری
theoretically  ->  از نظر تئوری
thereafter  ->  بعد از آن
thinker  ->  متفکر
thoughtfully  ->  متفکرانه
thoughtless  ->  بی فکر
thread  ->  نخ
threshold  ->  آستانه
thriving  ->  پر رونق
throne  ->  تخت پادشاهی
timber  ->  چوب
timid  ->  ترسو
tire  ->  لاستیک
tiresome  ->  کلافه کننده
toddler  ->  کودک نوپا
tolerance  ->  تحمل
torrential  ->  سیل آسا
totalitarian  ->  توتالیتر
toughness  ->  سختی
tractor  ->  تراکتور
trader  ->  معامله گر
tragically  ->  غم انگیز
trait  ->  صفت
tranquility  ->  آرامش
transition  ->  انتقال
transmission  ->  انتقال
transplant  ->  پیوند
trash  ->  زباله ها
trauma  ->  ضربه
traumatic  ->  پس از سانحه
tread  ->  آج
treaty  ->  معاهده
tribal  ->  قبیله‌ای
tribute  ->  احترام
trilogy  ->  سه گانه
trio  ->  سه نفر
troops  ->  نیروهای
troublesome  ->  دردسر ساز
trudge  ->  رد کردن
turbulent  ->  آشفته
turmoil  ->  آشفتگی
unaffected  ->  بی تاثیر
unanimous  ->  به اتفاق آرا
unanimously  ->  به اتفاق آرا
unattainable  ->  دست نیافتنی
unavoidably  ->  اجتناب ناپذیری
unbalanced  ->  نامتعادل
unbiased  ->  بی طرفانه
unconditional  ->  بدون قید و شرط
unconsciously  ->  ناخودآگاه
undeniably  ->  غیر قابل انکار
underdeveloped  ->  توسعه نیافته
underlying  ->  اساسی
undermine  ->  تضعیف کردن
undertaking  ->  تعهد
underway  ->  در حال انجام
undesirable  ->  نامطلوب
undeveloped  ->  توسعه نیافته
undoubted  ->  بدون شک
undue  ->  ناروا، بی مورد
unethical  ->  غیر اخلاقی
uneven  ->  ناهموار. ناجور
uneventful  ->  بی حادثه
unfavourable  ->  نامطلوب
unimaginable  ->  غیر قابل تصور
uninhabited  ->  غیر مسکونی
unprecedented  ->  بی سابقه
unrest  ->  نا آرام
unscrupulous  ->  بی وجدان
unsustainable  ->  ناپایدار
unwise  ->  نابخردانه
uphill  ->  سربالایی
uphold  ->  حفظ کردن
upkeep  ->  نگهداری
utter  ->  مطلقا
vaccinate  ->  واکسن زدن
vaccination  ->  واکسیناسیون
vaccine  ->  واکسن
vaguely  ->  به طور مبهم
validity  ->  اعتبار
vandalism  ->  وندالیسم
vanity  ->  غرور
velvet  ->  مخملی
vent  ->  تهویه
venture  ->  ریسک
verbal  ->  کلامی
verdict  ->  حکم
verge  ->  لبه
versatile  ->  همه کاره
veteran  ->  کهنه سرباز
viable  ->  قابل دوام
vice  ->  معاون
vicinity  ->  مجاورت، همسایگی
vicious  ->  شریر، بدجنس، حیوان صفت
villager  ->  روستایی
violate  ->  نقض
virgin  ->  باکره
virtue  ->  تقوا
visibly  ->  به طور قابل مشاهده
vitality  ->  سرزندگی
vitally  ->  حیاتی
vivacious  ->  سرزنده
vocation  ->  حرفه
vocational  ->  فنی و حرفه ای
voluntarily  ->  به طور داوطلبانه
vomit  ->  استفراغ
voter  ->  رای دهنده
vow  ->  نذر
vulnerable  ->  آسیب پذیر
warehouse  ->  انبار
wary  ->  محتاط
wavelength  ->  طول موج
weary  ->  خسته
weed  ->  علف هرز
weep  ->  اشک ریختن
whereby  ->  به موجب آن
whim  ->  هوی و هوس
wholeheartedly  ->  از صمیم قلب
wholly  ->  کاملا
wicked  ->  شریر
wield  ->  اعمال کردن
wilderness  ->  بیابان
willpower  ->  قدرت اراده
wink  ->  چشمک
withdrawal  ->  برداشت از حساب
withdrawn  ->  برداشته شد
withstand  ->  تحمل کند
woodland  ->  جنگل
workaholic  ->  معتاد به کار
would-be  ->  خواهد بود
wreck  ->  خراب کردن
wreckage  ->  خرابه
wretched  ->  بدبخت
wrinkle  ->  چین و چروک
wrinkled  ->  چین خورده
xenophobia  ->  بیگانه هراسی
yearn  ->  مشتاق بودن
yield  ->  بازده